Абиссальная зона : Глубоководная область дна Мирового океана (от 2500 до 6000 м), занимающая 3/4 его площади.
Абляции ледников : Уменьшение массы ледников при таянии, испарении или отделении айсбергов.
Абразия : Процесс разрушения волнами прибоя надводного и подводного (не глубже 200 м, где еще действуют ветровые волны) берегов водоемов.
Абсолютная влажность воздуха : Количество водяного пара, его плотность в воздухе, в г/м3.
Абсолютный или изотопный возраст горных пород : Количество тысяч и миллионов лет (геологический возраст) от образования горной породы до наших дней.
Адаптация : Приспособление организмов к новой географической среде (условиям существования).
Адвекция . 1. в
метеорологии : Перенос воздушных масс (с их температурой, влажностью, атмосферным давлением) в горизонтальном направлении в силу разницы в атмосферном давлении над подстилающей поверхностью (обычно над сушей и морем); важный фактор формирования климата.
Адыры : Холмисто-увалистые предгорья в Ферганской впадине.
Азиатский зимний максимум : Обширная область, объединяющая несколько центров зарождения высокого атмосферного давления.
Азорский максимум, или североатлантический антициклон : Область высокого атмосферного давления, периодически возникающего во все месяцы года на участке субтропического пояса с центром вблизи Азорских островов Атлантического океана.
Айсберги : Крупные глыбы льда, откалывающиеся от края ледниковых покровов Антарктиды, Гренландии и других арктических островов.
Акватория : Водная поверхность, а также каждый ее естественный или искусственный участок в отдельности: море, озеро, водохранилище, бухта и другие.
Акклиматизация : Процесс приспособления растений и животных к новым условиям обитания.
Аккумуляция : Процесс отложения рыхлого минерального, органического материала и солей.
Активные температуры : Температуры воздуха, превышающие +10°С в среднем за сутки.
Алас : Плоскодонная котловина.
Алеутский минимум : Область низкого атмосферного давления близ Алеутских островов Тихого океана, проявляющаяся в основном зимой.
Аллювий, аллювиальные равнины : Осадочные отложения рыхлых горных пород в руслах рек, на поймах и старицах.
Альбедо : Способность поверхностей или отдельных тел отражать солнечную радиацию.
Альпийская складчатость : Комплекс горообразования, вулканизма и извержения гранитных магм.
Альпийские луга : Низкотравная (10-15 см) растительность на верхнем пределе ее произрастания, преимущественно в приокеанических и приморских долготных зонах.
Альпийский пояс : В широком понимании высокогорная область выше границы леса и криволесий.
Амплитуда температур : Разность между минимальными абсолютными или средними температурами воздуха за сутки, месяц или год.
Антеклиза : Обширное (поперечником в сотни километров) поднятие (свод) поверхности платформенного фундамента с маломощным осадочным покровом.
Антиклиналь : Форма залегания (вытянутая складка) слоев горных пород с выпуклостью вверх.
Антиклинорий : Чередование антиклиналей и синклиналей, раздробленных тектоническими трещинами и сбросами, но поднятых вместе в виде широкой и протяженной, часто на сотни километров, выпуклой структуры.
Антипассат : Воздух верхней тропосферы и нижней стратосферы в тропических широтах, движущийся преимущественно в восточном направлении над пассатным потоком у земной поверхности, идущим к западу.
Антициклон : Область высокого атмосферного давления в тропосфере с постепенным его понижением от центральной части к периферии.
Антропогенный ландшафт : Природный ландшафт, преобразованный человеком, чаще целенаправленно, реже неосознанно.
Аридный климат : Сухой, когда количество атмосферных осадков за год в несколько раз меньше испаряемости.
Арктический антициклон : Область преобладающего повышенного атмосферного давления до высот 3-4 км в связи с низкими температурами в арктическом географическом поясе.
Арктический воздух : Воздушная масса, формирующаяся в арктическом географическом поясе, в основном над Северным Ледовитым океаном.
Арктический климат : Тип климата, характерный для Арктического географического пояса и части Субарктики.
Арктический пояс : Самый северный географический пояс Земли с южной границей условно по изотерме +5°С самого теплого месяца.
Артезианские воды : Подземные напорные пластовые воды.
Архипелаг : Группа островов, лежащих на небольшом расстоянии друг от друга, с Однородным геологическим происхождением и близких по строению.
Асимметрия форм рельефа : Различие в строении, углах наклона и протяженности склонов, противоположно расположенных в одном горном хребте или возвышенности.
Астеносфера : Одна из сфер Земли с верхней границей, разделяющей верхнюю и нижнюю, более плотную часть мантии.
Атмосфера : Газообразная (воздушная) оболочка Земли, связанная с ней силой тяжести и совместным вращением.
Атмосферная циркуляция : Смотрите Циркуляция.
Атмосферное давление : Тяжесть столба воздуха от его верхнего предела до земной поверхности или наземных предметов на данном высотном уровне.
Атмосферные осадки : Вода в жидком (морось, дождь) и твердом (крупа, снег, град) виде, выпадающая из облаков в результате конденсации паров, поднимающихся в основном с океанов и морей (испаряемая вода с суши составляет около 10% атмосферных осадков).
Атмосферный фронт : Зона раздела различных воздушных масс в тропосфере, например арктического и полярного воздуха.
Атолл : Кольцеобразный коралловый остров в виде узкой гряды, окружающий или полуокружающий неглубокую лагуну.
Аэрация почвы : Воздушная вентиляция почв.
Бабье лето : Временный возврат теплой и сухой солнечной погоды осенью  в Европе и Северной Америке (где называется индейским летом).
Базальт : Наиболее распространенная на Земле вулканическая, эффузивная горная порода черного или темно-серого цвета, состоящая из основных минералов (авгит, габбро, плагиоклаз и часто оливин).
Базальтовый слой : Нижний слой земной коры.
Базис эрозии : Место впадения водотока (реки, ручья) в другую водную систему, ниже уровня которой прекращается роющее действие воды и углубление дна водостока.
Байкальская складчатость : Вторая по древности эпоха интенсивного горообразовании, проходившая в конце протерозойского и начале кембрийского периодов геологической истории Земли.
Байрачный лес : Широколиственный лес (дуб, ясень и другие) по верховьям и склонам балок в лесостепной и степной зонах европейской части.
Балка : Суходол , падь (в Сибири), байрак (на Украине).
Бар : Узкий, вытянутый вдоль берега вал, полоса суши, образованная отложениями рыхлого материала (песок, ракушка, реже галька).
Бараний лоб : Скалистый холм овальной формы высотой не более 50 м при длине от десятков до сотен метров.
Барическая депрессия : Область с пониженным атмосферным давлением относительно окружающих пространств.
Барометр : Прибор для измерения атмосферного давления.
Барометрический максимум : Область наивысшего атмосферного давления в центральной части антициклона, но часто так называют весь ареал распространения антициклона.
Барометрический минимум : Область самого низкого атмосферного давления в центре циклона, но часто называют и всю область циклона, а также всю полосу экваториального географического пояса.
Барранкосы : Глубокие борозды типа крутостенных оврагов, прорезывающие склоны вулканов от кратера до подошвы.
Бархан : Песчаный холм серповидной формы, навеянный ветром и не закрепленный растительностью в пустынях и полупустынях.
Батиальная зона : Промежуточная область между шельфом и дном Мирового океана, занимающая почти 1/5 часть его дна между 200 и 3000 м.
Батолит : Крупный массив глубинных (интрузивных) горных пород гранитоидного состава, залегающих среди осадочных толщ складчатых областей и в ядрах антиклинориев.
Бедленд, или бэдленд, : Тип рельефа с густой сетью разветвленных оврагов и сухих, относительно узких долин, углубленных на десятки и даже сотни метров, часто с острыми гребнями водоразделов.
Безморозный период : Время между среднемноголетними датами последнего заморозка весной и первого осенью.
Безотходное использование воды : Водосберегающая политика.
Белки : Термин, принятый жителями Южной Сибири для Саянских и Алтайских гор, в которых снег не сходит с вершин круглый год или часто остаются перелетки снега Чуйские, Катунские, Агульские белки.
Белый уголь : Образное выражение, применяемое для обозначения энергии естественных водных потоков, которую технически возможно использовать для выработки электроэнергии на ГЭС.
Бентос : Совокупность растительных и животных организмов, обитающих на грунте и в грунте морей, озер и рек.
Берег : Граница суши с водоемом (океан, море, озеро, водохранилище) или с водотоком (река, ручей, временный поток).
Береговой склон : Наклонный участок земли, берега водоема.
Бессточная область : Обширная территория, с которой речной сток не достигает Мирового океана.
Бечевник : Наклонная прибрежная полоса, часть речного русла, положение которого определяется уровнями максимального (во время половодья) и минимального (меженного) стояния воды в реке.
Биогенные породы : Органогенные осадочные горные породы, накапливающиеся при отмирании больших масс растений и животных на данной территории, например каменные угли, торф, ракушечники, известняки и др.
Биогеоценоз : Постоянно развивающееся в процессе обмена веществ и энергии устойчивое соединение живых организмов с косной средой (горными породами и воздухом) на ограниченном пространстве.
Биологическая продуктивность : Общий вес, количество органического вещества , включая микроорганизмы, растения и животных, прирастаемого в год на определенной наземной площади или дна водоема (в биоценозе).
Биомасса : Количество или вес особей одного или группы видов, а при необходимости и биоценоза в целом с объема или площади их местообитания.
Биосфера : Оболочка существования и жизнедеятельности всех организмов Земли: микроорганизмов, растений, животных.
Биоценоз : Органическая часть биогеоценоза.
Блуждающее озеро, странствующее озеро : Бессточный водоем, в разные годы меняющий свои размеры, местоположение и часто соленость.
Блюдце : Плоскодонное, чаще округлое понижение (западина, впадина) в лесостепной, степной и полупустынной зонах.
Болота : Природный комплекс с избыточным увлажнением почвогрунтов, влаголюбивыми растительностью и животным населением, с накоплением перегнившей органической массы  и не полностью.
Бонитет леса : Показатель продуктивности леса.
Бор : Сосновый лес, обычный для таежной, смешанно-лесной и лесостепной природных зон.
Бора : Сильный холодный ветер с хребтов, разделяющих сильно охлажденную и более теплую (особенно приморскую) поверхность у их подножий.
Бореальная зона : Природная зона умеренного географического пояса северного полушария с холодной зимой и теплым летом.
Брекчия : Неокатанные  обломки различных горных пород в поперечнике более 1 см (глыбовые брекчии.
Бриз : Местный ветер небольшой скорости, меняющий направление дважды в сутки.
Бровка террасы : Резкий или сглаженный, но заметный перегиб от равнинной (плоской или наклонной) поверхности к крутому склону.
Булгуннях : Смотрите Гидролакколит.
Буран : Снежная вьюга, пурга, ураган со снегом, метель в степи при низкой температуре воздуха.
Бухта : Вдающаяся в сушу небольшая часть моря или озера, небольшой залив, закрытый от воздействия штормов.
Вади : Сухие долины в пустынях Северной Африки и Аравийского полуострова.
Валун : Окатанный водой или отполированный ледником кусок горной породы в поперечнике от 10 см и больше.
Ванна : Замкнутая впадина на поверхности Земли.
Ватты : Полоса плоских низменных побережий приливных морей, заливаемая при приливе и осушаемая в отлив («осушка»).
Вдольбереговое течение : Перемещение воды в океанах, морях или озерах с постоянным направлением параллельно берегу.
Вегетационный период : Часть года, в течение которой по погодным условиям происходит развитие растений (вегетация).
Вековое колебание климата : Ритмические потепления, похолодания, увлажнение и иссушение климата, зависящие вернее всего от изменений солнечной активности с промежутками в 11, 35, 80.
Вертикальная зональность : Закономерное изменение природных комплексов и составляющих их компонентов как в высоту, так и в глубину.
Верховодка : Временное скопление воды, верхний горизонт грунтовых вод обычно в виде отдельных линз, образующихся от просачивания талых или дождевых вод.
Ветер : Движение воздуха, горизонтальное у земной поверхности.
Ветровая эрозия : Разрушающее действие ветра: развевание песков, лёссов, вспаханных почв, возбуждение пыльных бурь, шлифовка скал, камней, строений, механизмов несомыми твердыми частицами, поднятыми силой ветра.
Вечная мерзлота : Смотрите Многолетняя мерзлота грунтов.
Вечнозеленая растительность : Растения, сохраняющие круглый год зеленый цвет, не имеющие определенных сезонов спада и возобновления листьев, хвои или стеблей, а заменяющие их по мере устаревания новыми.
Взброс : Массив слоистых или кристаллических горных пород, оторванный и поднятый над оставшимися в покое теми же породами действием тектонических сил по трещинам с углами не менее 45° к горизонтальной поверхности.
Взвешенные наносы : Твердые  частицы, движущиеся в толще потока, а также поднимаемые водоворотами от донных отложений.
Виргация : Разветвление от одного хребта нескольких складчатых хребтов в горной стране.
Висячая долина : Боковая долина крутого продольного профиля в устьевой части, иногда с водопадом или значительным перегибом русла при впадении в другую реку или море.
Вихри : Вращательное движение газов или жидкостей вокруг мгновенной неподвижной или перемещающейся оси.
Влажность воздуха : Количество водяного пара, содержащегося в воздухе.
Влажность почвы : Отношение веса почвы в естественном состоянии к ее весу в сухом виде в %.
Внутреннее море : Глубоко вдающееся в сушу море, сообщается проливами с океаном или прилегающим морем (например, Балтийское, Мраморное).
Внутригорная впадина : Резкое и значительное расширение горной долины, возникшее путем тектонического опускания блока или, наоборот, оставшегося на месте при подъеме ограничивающих его хребтов.
Вода : Бесцветная жидкость без вкуса и запаха.
Водные массы океана и их типы : Большие объемы воды с однотипными температурой, соленостью, особенностями планктона и животным миром, отличающиеся от окружающих вод.
Водные ресурсы : Водные объекты (реки, озера, водохранилища, артезианские воды) какой-либо территории (ландшафта, района, государства и тому подобного), которые могут быть так или иначе использованы для общественного блага: для питания, транспортных путей, полива полей, производства химических, синтетических и других промышленных изделий, для рыбо и птицеразведения и тому подобного.
Водоворот : Участок реки или водоема, где возникает круговое движение воды в результате слияния двух потоков, резкого расширения русла или обтекания потоком выступов берега и другого.
Водоем : Скопление бессточных или с замедленным стоком вод в естественных (озера) или искусственных (водохранилища, пруды) понижениях земной поверхности.
Водоносный слой, горизонт : Толща горной породы или почвы, поры и трещины которой заполнены подземной водой.
Водопад : Падение воды с уступа речного русла.
Водопроницаемые породы : Горные породы (почвогрунты), способные пропускать воду, что зависит от размеров и количества пор, пустот, трещин.
Водораздел : Граница (линия раздела) между бассейнами (водосборами) водоемов, водотоков или скоплений подземных вод.
Водосборная воронка : Форма рельефа, образованная несколькими сходящимися вместе водотоками или эрозионными бороздами временных водотоков в истоке горной реки, откуда она идет уже в одном русле.
Водосборный бассейн, водосборная площадь,
водосбор : Территория, с которой в данную реку, озеро или речную систему стекают поверхностные и подземные воды.
Водоупорные горные породы : Практически не пропускающие воду, например глина, плотные породы, лишенные трещин, а также мерзлые грунты, поры и трещины которых заполнены льдом.
Водохранилище : Искусственный водоем, создаваемый для накопления и последующего использования воды.
Возвышенность : Форма рельефа, имеющая заметный склон к прилегающей низменности и относительно обширную равнинную или волнистую поверхность как на суше, так и на дне водоемов.
Воздействие человеческой деятельности на
ландшафты : Постоянное, сезонное, периодическое или случайное изменение естественных  ландшафтов в процессе жизнедеятельности человеческого общества или отдельного человека.
Воздушная масса : Обширная часть воздуха тропосферы, соизмеримая с отдельными континентами, имеющая однородные свойства, полученные от той территории или акватории, над которой она сформировалась: запасы влаги, тепла, пыли.
Воздушные фронты : Смотрите Атмосферные фронты.
Возобновление природных ресурсов : Самовосстановление ресурсов ландшафта  в результате взаимодействия между его компонентами и круговоротом вещества в лито-, атмо-, гидро-, биосферах.
Возраст геологический : Время, прошедшее с момента какого-либо события в истории Земли: складчатость, трансгрессия, оледенение, образование осадочных горных пород, внедрение интрузий и так далее.
Возрожденные горы : Складчато-глыбовые и глыбовые горы, поднявшиеся новейшими тектоническими движениями на месте древних складчатых гор, давно выровненных, превращенных в равнину, напоминающую платформу.
Волны : Колебательное движение верхнего слоя водной массы водоема.
Волок : Участок водного пути (сухопутье).
Воронка карстовая : Форма рельефа в виде впадины конической или чашеобразной формы глубиной от 2-3 до 15-17 м при ширине по верхнему краю от нескольких до десятков метров.
Восходящий источник : Выход на земную поверхность подземных вод под давлением из пор, трещин или полостей породы и имеющий восходящее направление движения воды.
Вулкан : Высокая гора конической формы, образованная вулканическими обломками, пеплом, сцементированными раскаленными лавами, с кратером наверху, из которого временами происходят извержения, с силой выбрасываются расплавленные лавы, газы, обломки горных пород и другие продукты.
Вулканизм : Процессы и явления, происходящие в недрах и на поверхности земной коры в связи с перемещением магмы.
Вулканические горные породы : Магматические горные породы, выброшенные и выжатые в виде вязкой лавы вулканами центрального типа или образованные из излившейся жидкой лавы трещинных вулканов, а также не дошедшие до поверхности и застывшие в земных слоях.
Вулканические острова : Острова, возникшие в результате подводных вулканических извержений и появившиеся над уровнем моря острова из излившихся вулканических горных пород.
Выветривание : Постоянно идущий процесс разрушения и химического изменения всех горных пород на суше.
Выдувание почвы : Сдувание ветром рыхлого верхнего слоя почвы (дефляция) часто вместе с посеянными семенами, а иногда и всходами.
Вымирание : Частичное или повсеместное исчезновение отдельных видов или всего рода животных и растений в процессе развития биосферы.
Вымораживание : Постепенное смещение всех твердых частей (щебень, валуны, деревянные столбы, фундамент строений и тому подобного) на поверхность из сезонно оттаивающего (деятельного) слоя при новом его промерзании осенью.
Высокогорная пустыня : Ландшафт высокогорья выше 3500 м в резко континентальных долготных зонах и преимущественно в Азии (Тибет, Монгольский Алтай, Восточный Памир), там, где в приморских и умеренно континентальных зонах обычны вечные снега.
Высокогорный, или альпийский рельеф : Тип рельефа, формирующегося действием ледников, снежников.
Высокотравье : Травянистые растения, образующие сомкнутый ярус высотой от 2 до 4 м.
Высотная поясность : Часть вертикальной зональности природных явлений и процессов, относящихся только к горам.
Выщелачивание : Растворение и вынос подземными и поверхностными водами в первую очередь легкорастворимых частей горной породы, грунта, почвы.
Вьюга : Сильный ветер со снегом, снежная буря, то же, что метель, буран, пурга.
Гавань : Небольшой залив моря, озера, реки, естественно или искусственно защищенный от штормов, течений, ледяных напоров и приспособленный для стоянки судов.
Галерейные леса : Узкие полосы лесов по берегам рек вне лесных природных зон.
Гало : Общее название оптических явлений в атмосфере, возникающих в результате отражения или преломления света в ледяных кристаллах облаков или тумана (например, в горах).
Галофиты : Растения, приспособившиеся к жизни на засоленных почвах.
Гальки : Окатанные и отшлифованные текучей водой или морскими прибоями обломки горных пород от 10 до 100 мм в поперечнике.
Гамада, хамада : Арабское название любых каменистых пустынь.
Гарига : Низкорослые разреженные заросли вечнозеленых ксерофитовых кустарников и полукустарников.
Гафы : Названия неглубоких полупресноводных заливов.
Гейзеры : Фонтаны горячей воды и пара, с шумом выбрасываемые из подземного их скопления по вертикальному каналу на поверхность Земли.
Географический пояс : Природный, физико-географический.
География, географические специальности : Система наук, изучающая географическую оболочку.
Геологическая система : Комплекс горных пород, содержащих свойственный только для периода их накопления (отложений) характерный состав флоры, и фауны в окаменелом состоянии.
Геосинклиналь : Область длительного и интенсивного складкообразования земной коры.
Геотермический градиент : Приращение температуры горных пород с увеличением глубины на каждые 100 м.
Геохимические процессы : Круговорот атомов, движение , взаимодействие друг с другом и окружающими компонентами земных сфер, формирование новых соединений химических элементов, входящих в состав земной коры.
Геохронология : Раздел геологии, изучающий последовательность развития жизни на Земле, абсолютный возраст и относительный возраст горных пород.
Герцинская складчатость : Эпоха интенсивного горообразования, продолжавшаяся не менее 150 млн.
Гигрофилы : Животные и растения, приспособленные к обитанию в условиях высокой влажности на заболоченных территориях, во влажных лесах, поймах рек, почве.
Гигрофиты : Растения влажных местообитаний.
Гидробионты : Все организмы, живущие в воде и на дне водоемов и водотоков.
Гидрографическая сеть : Все водоемы и водотоки на какой-либо территории: озера, болота, водохранилища и другие постоянно и временно действующие водотоки.
Гидролакколиты : Бугры с ледяным ядром.
Гидросфера : Все воды Земли, ее водная оболочка, включающая всю воду (кроме химически связанной), расположенную на поверхности и в толще земной коры, в жидком, твердом и газообразном состоянии.
Гилейный лес, гилея : Тропический лес главным образом в бассейне реки Амазонки (Южная Америка).
Гирло : Дельтовый рукав реки, пролив, узкая протока, соединяющая лиман с морем; подводная часть дельты; речной фарватер при выходе из реки к морю.
Глаз бури : Область безоблачного затишья в центре тропического циклона диаметром 20-30 км, а иногда и до 60 км, тогда как кругом бушуют штормовые ветры, ливни и грозы.
Глетчер , горный ледник : Ранее широко распространенное название ледника, сохранившееся в зарубежной литературе.
Глинистая пустыня : Тип северных пустынь на глинистых грунтах.
Глинт : Обрывистый уступ в виде крутого склона куэсты.
Глубоководный желоб : Длинные узкие понижения дна океанов с глубинами свыше 5000 м, расположенные в переходной зоне между материком и океаном.
Глыбовые горы : Поднятия земной коры в результате тектонических разломов при повторных подъемах (движениях) древних, разрушенных горных систем (возрожденные горы).
Гляциодислокации : Образуемые давлением льда небольшие надвиги и складки поверхностных слоев льда в местах повышений ложа энергично двигающихся ледников.
Гнус : Общее название кровососущих летающих насекомых: мокрецов, мошки, Комаров , мух, слепней, оводов, снижающих работоспособность и вызывающих некоторые заболевания у людей.
Годовой сток : Количество воды, протекающее за год через живое сечение реки, выраженное в м3 или км3.
Гололед, ожеледь : Слой льда, образующегося на поверхности земли, деревьях, проводах, столбах, домах и других предметах путем намерзания капель переохлажденного дождя или тумана.
Голубой патруль : Школьные водные дозоры и сигнальные посты, охраняющие богатства и чистоту рек, озер, ручьев, родников, подземных вод.
Голубой уголь : Образное название ветровой энергии.
Гольцы : Сибирское название вершин гор, расположенных выше высотной зоны лесов.
Гора : Возвышение рельефа выше 200 м, резко поднимающееся среди относительно равнинных территорий, с хорошо обозначенным перегибом к крутым склонам, а также выделяющиеся вершины горных систем и хребтов.
Горизонтальная слоистость : Чередование различных по цвету или крупности составляющего материала слоев горных пород, залегающих параллельно горизонтальной плоскости и близко по отношению друг к другу.
Горная пустыня : Высотная ландшафтная зона тропических, субтропических и, иногда умеренных географических поясов (в континентальных секторах).
Горная система : Обширное поднятие земной коры (антиклинорий), созданное одной складчатостью и состоящее из группы параллельных хребтов и горных цепей (например, Урал) или расходящихся лучеобразно (Алтай), а также нагорий (Верхоянское), разделенных межгорными впадинами.
Горная цепь : Часть горной системы, состоящая из коротких хребтов или массивов, расположенных линейно друг за другом и разделенных тектоническими или эрозионными понижениями.
Горно-долинное оледенение : Ледники в верховьях речных долин, начинающиеся от нивальной зоны гор.
Горные породы : Основное вещество, слагающее земную кору.
Горные почвы : Почвы, формирующиеся на склонах и вершинах гор в условиях интенсивной эрозии и смыва поверхностных продуктов выветривания, а поэтому обычно маломощные и перегруженные обломочно-каменистым материалом.
Городской климат : Климат большого города  существенно отличается от климата естественных ландшафтов благодаря антропогенному влиянию.
Горообразование : Тектонический подъем участков земной коры и сопутствующая ему денудация.
Горст : Участок земной коры, резко приподнятый над окружающей местностью по вертикальным или крутонаклонным тектоническим разломам (сбросам) до нескольких сотен и даже тысяч метров в высоту, длиною в десятки сотен километров при ширине в десятки километров с крутыми склонами, например Сьерра Невада в Испании с высотой до 2000 м при ширине 90 км.
Горы возрожденные : Смотрите Возрожденные горы.
Грабен : Участок земной коры, опущенный относительно окружающей местности по крутым или вертикальным тектоническим разломам.
Гравий : Рыхлая осадочная горная порода, состоящая из округлых, окатанных обломков пород размером 1-10 мм.
Град : Вид атмосферных осадков; плотные частицы льда (градины) неправильной формы размером от мелкой горошины до куриного яйца, обычно с несколькими слоями разной плотности.
Гражданские сумерки : Наиболее светлая часть периода плавного перехода от ночной тьмы к дневному свету утром и обратно.
Гранит : Самая распространенная на Земле интрузивная горная порода кислого химического состава.
Гранитный слой : Слой гранитов и гнейсов, располагающийся на материках непосредственно под осадочным слоем литосферы поверх глубинного базальтового слоя.
Гривы : Линейно вытянутая возвышенная форма рельефа длиной от нескольких до сотен километров при ширине от десятков до сотен метров.
Гроза : Атмосферное явление, при котором в мощных кучево-дождевых облаках и между облаками и землей возникают сильные электрические разряды.
Грунтовые воды : Безнапорные подземные воды первого от поверхности водоносного горизонта, расположенного на первом водоупорном слое, не перекрытом водонепроницаемой породой.
Грядовые пески : Одна из главных форм рельефа песчаных пустынь в Средней и Центральной Азии, Австралии, Африке.
Гряды : Общее название небольших в длину и высоту возвышенностей различного происхождения: холмистые.
Гуано : Ценное азотно-фосфорное органическое удобрение.
Губа : Морской залив в устье реки.
Гумидный климат : Климат избыточного увлажнения, при котором атмосферных осадков больше, чем может испариться и просочиться в почвогрунты.
Густота речной сети : Отношение длины всех водотоков какой-либо территории или бассейна к плошали, выпаженное в км/км2.
Дайка : Малая интрузия, заполнившая трещину, обычно с параллельными стенками, пересекающая окружающие породы.
Движение вод мирового океана : Колебательное  и поступательное движение, происходящее по разным причинам: 1.
Дебит : Количество воды, нефти, газа, даваемое родником, буровой скважиной или колодцем в единицу времени.
Деградация почв : Постепенное ухудшение и утрата плодородия почв в результате вымывания питательных веществ, уменьшения гумуса, разрушения структуры и тому подобное.
Дельта : Форма устья реки, возникающая на мелководных участках моря или озера при впадении реки, несущей много наносов.
Делювий : Делювиальные отложения, покровы на склонах и накапливающиеся вдоль подножия гор и возвышенностей.
Денудация : Главный физико-химический процесс, выравнивающий земные неровности.
Дернина, дерн : Поверхностный слой почвы с травяным покровом и пронизанный густым переплетением корней.
Джайляу : Летнее пастбище, луга в субальпийской и альпийской зонах гор Средней Азии, а также Алтая (наз.
Джунгли : Древесно-кустарниковые заросли с жесткими травами и обилием лиан в тропических и субтропических зонах.
Динамика ландшафта : Естественное развитие ландшафта (его жизнь) без изменения внешнего вида (структуры) и резких смен биологической производительности, но при постепенном ее наращивании (реже убывании).
Дислокация : Нарушение первоначального положения слоев и тел горных пород.
Дождь : Преобладающий вид атмосферных осадков, выпадающих в виде капель воды из слоисто-дождевых облаков (обложной дождь) и кучево-дождевых (ливневый дождь).
Долинно-балочный рельеф : Тип эрозионного рельефа, состоящего из густой сети балок с плоским днищем и пологими склонами, переходящими в выпуклые междуречья и объединенными более редкими широкими долинами рек, в которые открываются устья балок.
Долины речные : Созданные водотоками вытянутые углубления на земной поверхности с общим уклоном в сторону текущей воды.
Донные отложения, осадки -
разнообразные минеральные и органические
частицы, накапливающиеся на дне и подводных склонах водоемов : Озер, прудов, водохранилищ.
Донный лед : Лед, образующийся до возникновения ледяного покрова на реках, в озерах, морских  отмелях, а также на погруженных в воду предметах при переохлаждении воды.
Древовидный ледник : Тип горного ледника.
Древостой : Совокупность деревьев, образующих лес.
Дренаж : Способ осушения излишне увлажненных земель путем отвода поверхностных и подземных вод.
Дресва : Рыхлый продукт физического выветривания твердых горных пород.
Друмлины : Холм ледникового происхождения.
Дубрава : Многоярусный широколиственный лес, в древостое которого преобладают различные виды дуба в сопровождении спутников.
Дымка атмосферная : Легкое помутнение воздуха в приземном слое в результате рассеяния света на мельчайших капельках воды или кристаллах льда.
Дюна : Песчаный холм или гряда холмов, возникающая под действием ветра, на песчаных побережьях  морских или озерных водоемов, на речных террасах, на древнеледниковых (зандровых) песках.
Едома : Небольшая плосковершинная возвышенность, холм до десятков метров относительной высоты.
Елань : Поляна среди леса, пастбище, луг.
Ерник : Заросли полярных и горных, иногда стелющихся, низкорослых кустарников из карликовых берез, полярных ив и других растений.
Жаркий климат : Климат, при котором температура воздуха в среднем за год превышает 20°С.
Жестколиственный лес : Вечнозеленый лес из ксерофитных, жестколистных пород.
Жесткость воды : Свойство воды, содержащей ионы кальция и магния главным образом в виде карбонатов.
Живое  сечение реки (потока) : Плоскость сечения потока, перпендикулярная направлению течения.
Жильные льды : Включения льда в виде клинообразных тел в горную породу.
Забереги : Полосы льда, окаймляющие берега рек, озер и водохранилищ, при незамерзшей остальной части водного пространства.
Заболачивание : Нарастающее переувлажнение почвогрунтов с изменением почвенно-растительного покрова.
Заводь : Небольшой речной залив с низкими берегами и медленным течением, а часто и обратным течению реки.
Загрязнение среды : Появление в атмосфере, природной воде или почвах несвойственных данному региону твердых, жидких или газообразных механических, биологических или химических частиц и соединений, а также повышение среднемноголетнего их содержания, изменяющие естественное состояние воздуха, воды или почв.
Зажор : Закупорка живого сечения реки массой внутриводного льда и шуги во время осеннего ледохода и в начале ледостава.
Займище : Наиболее низкие места речных пойм, долго занятые водой после половодья.
Заказник : Территория или акватория, где постоянно или временно запрещены отдельные виды и формы хозяйственной деятельности.
Закрепление песков : Борьба с подвижностью песков и заносом ими хозяйственных объектов.
Залив : Часть океана, моря, озера, водохранилища, вдающаяся в сушу и слабо отчлененная от основного водного бассейна.
Залом : Скопление деревьев в виде плотины в узких или обмелевших местах русла рек.
Заморозок, утренник : Понижение температуры воздуха ниже 0°С вечером и ночью при положительной температуре днем.
Зандры : Песчаные или с примесью щебня равнины вдоль окраин современных или древних уже сошедших покровных ледников.
Запасы полезных ископаемых : Весовое  или объемное (в жидких и газообразных) количество полезного ископаемого в расчете на данную площадь.
Заповедник : Территория (или акватория), где сохраняется в естественном состоянии природный комплекс (ландшафт, биогеоценоз).
Зарегулированный сток : Речной сток, режим которого изменен в сторону большей равномерности в течение года.
Засоление почв : Процесс накопления вредных для растений солей в почве, главным образом хлористого и сернокислого натрия.
Засуха : Снижение против обычного (среднесезонного) количества атмосферных осадков при повышении температур и понижении влажности воздуха и почв.
Засухоустойчивость : Способность растительности переносить длительные перегрев и недостаток влаги , а также быстро возрождаться после завядания из-за обезвоживания.
Затон : Вытянутый залив в реке, отделившийся косой от проточной части русла или образованный из старицы, протоки и имеющий слепой конец.
Затопление : Покрытие водой днища долины или территории, прилегающей к реке.
Затор льда : Нагромождение льдин во время ледохода в сужениях русла на мелях, при крутых поворотах долины, где затруднен проход льдин.
Захоронение отходов : Один из способов борьбы против загрязнения природной среды путем закапывания бытовых и промышленных отходов в отработанные шахты и буровые скважины, на дно океанических впадин, реже.
Зеленые водоросли : Тип низших растений, около 5,5 тыс.
Зеленый патруль : Охрана растений школьниками в условиях освоенной и преобразованной человеком природы, в городах и поселках, в пригородных зонах отдыха, парках, лесах.
Землетрясение : Толчки и колебания с образованием смещений и трещин земной поверхности вследствие тектонических движений (процессов горообразования).
Земляные пирамиды : Конусообразные остатки размытых дождями и ручьями мощных несортированных рыхлых отложений.
Земная кора : Внешняя оболочка земного шара.
Зоны ветров : Зоны различных режимов ветров в атмосферной циркуляции географической оболочки.
Зоны географические : Широкие полосы на земной поверхности, ограниченные сходными чертами гидроклиматических (энерготворимых) и биогенных (жизненно-пищевых) природных ресурсов.
Зооценоз : Животная часть биоценоза.
Зыбун : Участок зарастающего водоема.
Избыточное увлажнение территории : Участок суши, на котором выпадающих атмосферных осадков больше, чем может испаряться.
Излучина реки : Различают вынужденные изгибы, когда река, например, обтекает выступ склона, и свободный изгиб.
Изморозь : Рыхлые снегообразные мелкие кристаллы льда, нарастающие на ветвях деревьев, проводах и других предметах обычно при намерзании капель переохлажденного тумана.
Инверсия температур : Повышение температур воздуха с высотой вопреки правилу ее убывания (понижения).
Иней : Тонкий слой ледяных кристаллов, образующийся в холодные, ясные и тихие ночи на поверхности земли, травах и предметах с отрицательными температурами, более низкими, чем у воздуха.
Инсоляция : Облучение солнечной радиацией земной поверхности.
Интродукция : Успешное внедрение каких-либо видов или сортов растений и животных в новые условия обитания за пределы привычных для них ареалов.
Инфильтрация : То же, что и просачивание воды в глубь почвогрунтов и горных пород по трещинам, пустотам, порам, а также капиллярам к уровню грунтовых вод.
Ионосфера : Обнимающий Землю слой с разреженными электронами, атомными и молекулярными ионами, образующими высокоэлектропроводную среду.
Ирригация : Смотрите Орошение и Мелиорация.
Ископаемый лед : Разнообразные ледяные включения в земных слоях.
Исландский минимум : Область пониженного атмосферного давления и постоянного возникновения циклонов на севере Атлантического океана.
Испарение : Переход вещества из жидкого или твердого состояния в газообразное.
Испаряемость : Максимально возможное испарение при данных метеорологических условиях с достаточно увлажненной подстилающей поверхности, то есть в условиях неограниченного запаса влаги.
Исчезающие реки : Водотоки, скрывающиеся под землю в карстовых воронках, понорах,.
Каатинга : Полупустынный ландшафт из мелколиственных кустарников и низкорослых деревьев (до 8-10 м) тропических ксерофитных листопадных редколесий на северо-востоке Бразильского плоскогорья (Южная Америка).
Каледонская складчатость : Складкообразование, тектонические движения, интенсивная вулканическая деятельность с широким внедрением расплавленных магм (гранитизация), длившаяся с разной степенью интенсивности в течение кембрийского, ордовикского и силурийского периодов палеозойской эры.
Кальдера : Округлая обширная, более 20 км, впадина у вулканического кратера глубиной до сотен метров.
Каменные кольца : Бордюры щебня и мелких каменных обломков вокруг слегка вспученного пяти-шестигранного или округлого мелкоземистого участка размером от 0,1 до 3 м в поперечнике.
Каменные реки : КУРУМЫ  - скопление крупных каменных обломков, вытянутых вдоль горных склонов,.
Камнепад : Обрушивание крупных каменных глыб, обломков пород и просто свободное падение камней на горных склонах под действием силы тяжести.
Кампос, кампус : Так называют саванны Бразилии.
Камы : Округлые в плане холмы высотой 2-5 м, изредка до 30 м, сложенные косослоистыми песками, гравием, галькой,.
Канал : Созданное искусственное русло, соединяющее два водоема или водотока с разным практическим назначением.
Каньон  - узкая
глубокая и крутосклонная долина реки в горах или на плато преимущественно в твердых или
плотных горных породах, а также в
зонах аридного климата, где
количество атмосферных осадков
меньше испаряемости. каньоны типичны
для базальтовых покровов, способных давать
глубокие вертикальные трещины, для известняков, лёссов, редко для песчаников, а также
для возрождающихся или
поднимающихся гор. величайший на
земле каньон создан рекой колорадо глубиной до
1800 м при длине 320 км на известняково-песчаниковом плато в сша. в нашей стране известны
каньоны в кавказских горах : Дарьяльское ущелье, в 100 базальтах плато Путорана на реке Курейке в Средней Сибири (глубина около 900 м при длине 130 км), на Урале (река Сакмара глубиной до 300 м), на Памире.
Карбонаты : Большая и разнообразная группа минералов (около 80), образованных солями углекислоты.
Карры : Небольшие остроконечные гребешки, разделяющие неглубокие крутосклонные впадины от нескольких сантиметров до 2 м.
Карстовые явления, карст : Процесс растворения горных пород  и возникновения своеобразных форм рельефа и водного режима.
Картографические проекции : Способы изображения сферической земной поверхности на плоскости листа.
Карьер : Искусственная (антропогенная) выемка в земной коре, созданная при добыче полезных ископаемых открытым способом: строительных материалов, нерудных и рудных.
Каскад : Естественный или искусственный водопад, низвергающийся по нескольким уступам, чаще всего твердых горных пород, например Йосемитский в США (общая высота падения.
Кедровый стланик : Дерево-куст, растущий несколькими тонкими стволами от одного корня на высоту 2-5 м и обладающий способностью полегать под снег при наступлении морозов, спасаясь от вымерзания.
Кекур : Столбовидная или конусообразная скала естественного происхождения, обычно в реках, морях или на их берегах.
Кимберлитовая трубка , или трубка взрыва, : Трубообразный канал с поперечником 0,4-1 км, по которому преимущественно на древних платформах произошел прорыв магматических растворов и газов.
Кислотность почвы : Свойство, которое приобретает почва при определенной концентрации в почвенном растворе ионов водорода.
Кислые дожди : Кислотные атмосферные осадки, содержащие значительные примеси серы от дымов химических и металлургических предприятий.
Климат : Многолетний режим погоды, типичный для данного района Земли, как бы средняя погода за много лет.
Климатические пояса : Крупнейшие климатические подразделения географической оболочки в виде широких полос, протягивающихся в общем параллельно плоскости экватора через сушу и океаны вокруг земного шара.
Климатические ресурсы : Неисчерпаемые зонально распределенные запасы световой и тепловой солнечной энергии, влаги и всех форм движения воздуха.
Климатические сезоны : Периоды года с чертами общности климатических факторов в каждом климатическом поясе, определяемых температурными и циркуляционными условиями.
Климатообразующие процессы : Процессы в атмосфере, формирующие климат Земли, природной зоны или отдельного региона.
Клиф : Обрыв или крутой уступ коренных пород на берегу озера или моря, образовавшийся в результате абразии.
Колки : Участки березовых рощ на лесостепных междуречьях преимущественно в Западной Сибири.
Комфортность ландшафта : Удобство, здоровое обитание, а также благоприятное эмоциональное действие данного ландшафта на жизнь людей (медико-биологическое и социально-психологическое).
Конденсация : Переход водяного пара в жидкость или лед.
Континентальный климат : Климат территорий с господством континентальных воздушных масс, что связано с влиянием крупных континентов или с минимальным воздействием морских влажных воздушных масс.
Конус выноса : Скопление в виде конуса валунов, гальки, песка, глины в устьях горных рек, падей, балок, оврагов при выходе их на равнины или на террасы широких долин.
Кора выветривания : Покров на коренных  горных породах, образовавшийся в результате различных типов их выветривания и выщелачивания.
Коренные горные породы : Магматическая или осадочная горная порода, не подвергшаяся существенному изменению выветриванием и денудацией после выхода на земную поверхность.
Корразия : Скоблящее, высверливающее, стирающее, шлифующее действие твердых частиц и обломков на коренную горную породу.
Коррозия : Химическое разъедание и растворение водой горных пород (карстовые явления), а при вулканических извержениях.
Коса : Низкая намывная полоса из гальки, песка, ракушек, протягивающаяся под углом от берега в акваторию моря, озера или реки.
Космополиты : В биологии виды, роды, семейства растений или животных, ареал которых охватывает почти весь земной шар (кроме Антарктиды).
Котловины : Округлые или слабо вытянутые впадины на земной поверхности размерами от нескольких метров до десятков километров.
Котлы выдувания : Вдающиеся в скалы неправильной формы полости, углубления в возвышенностях и скальных породах современных и древних пустынных ландшафтов, созданные процессами химического выветривания, корразии и дефляции.
Коэффициент стока : Часть (в процентах) воды атмосферных осадков, стекающих в водотоки с площади бассейнов.
Коэффициент увлажнения : Соотношение между количеством выпадающих атмосферных осадков за год или другое время и испаряемостью определенной территории.
Краевой прогиб : Предгорный прогиб, тектонический прогиб земной коры, образовавшийся в результате подъема гор на границе с платформой.
Красная книга. международный союз охраны
природы и природных ресурсов  в 1966 г. издал
первые тома красной книги. «красная книга
фактов» : Списки с описанием животных и растений, находящихся под угрозой полного исчезновения.
Красный снег : Массовое размножение водоросли хламидомонады  окрашивает снег в высоких горах и в полярных странах (Гренландия, острова Арктики).
Криволесье : Тип редкостойного леса с угнетенными, уродливыми деревьями, растущими на физиологическом пределе данного вида.
Крики : Русла рек, пересыхающих в сухое время года (временные водотоки), в Австралии.
Криогенез : Процессы изменения и отчасти преобразования минеральных, органических, водных и атмосферных составляющих географическую оболочку в связи с образованием льда при отрицательных температурах.
Крип : Медленное и постоянное сползание рыхлого покрова по покатостям рельефа.
Криптозой : Первый период геологической истории, при котором не существовала скелетная фауна, которая не обнаруживается в земных напластованиях архейской и протерозойской эр (время до кембрийского периода) (см.
Круговорот веществ на земле : Беспрерывный, периодически повторяющийся процесс.
Крупа снежная, ледяная : Вид твердых атмосферных осадков.
Кряж : Невысокая, в несколько десятков, реже сотен метров вытянутая пологосклонная возвышенность или ряд плосковерхих холмов (низкогорье).
Ксерофилы : Животные, приспособленные к длительному безводию.
Ксерофиты : Растения сухих местообитаний в степях, полупустынях и пустынях, способные переносить перегрев и обезвоживание при потерях воды до 20-50%.
Культурный ландшафт : Сознательно (целесообразно) измененный для практического использования человеком ландшафт, постоянно поддерживаемый и охраняемый от неблагоприятного воздействия, например оазис в пустыне, национальный парк, лесопарк в курортной зоне (рекреационный культурный ландшафт) и тому подобное.
Курган : Высокая (0,5-20 м) насыпь над древней могилой (скифские захоронения), также насыпанный казаками в старину холм среди равнинной степи для пограничного дозора.
Курчавые скалы : Скалистые выступы, отполированные двигавшимися ледниками.
Кустарник : Многолетнее невысокое  деревянистое растение, ветвящееся от одного корня с поверхности земли и в отличие от деревьев не имеющее главного ствола.
Кустарничек : Отличается от кустарника и меньшими размерами до 60 см высотой, и меньшей продолжительностью жизни 5-10 лет.
Куэсты : Ассиметричные гряды, образующиеся от эрозии и денудации в возвышенных районах, основание которых сложено наклонными слоями горных пород.
Лавина : Снежный обвал в крутосклонных горах при обильном снежном покрове.
Лакколиты : Не дошедшая при своем извержении до земной поверхности лава, застывшая на небольшой глубине между слоями осадочных горных пород, приподнявшая при этом верхний их слой в виде купола.
Ландшафт географический : Смотрите Географический ландшафт.
Ланды : Малопродуктивный ландшафт влажного морского климата взбугренных песков и болот, иногда с сосняками и вечнозелеными кустарничками и травами (вторичные пустоши).
Латерит : Своеобразная красноцветная горная порода, образуется в результате выветривания алюмосиликатов в условиях жаркого и влажного климата в зонах переменно влажных субэкваториальных, тропических и частично субтропических географических поясов.
Левада : Влажный пойменный лес из ольхи, вербы, тополя, вяза, растущий среди лугов с богатым травостоем вдоль многих рек европейской части.
Лед ископаемый : Смотрите Ископаемый лед.
Ледники : Превращенная в лед вода атмосферного происхождения.
Ледниковая эпоха : Отрезок времени в геологической истории Земли, когда в результате похолодания климата часть материка и шельфа была занята покровами льдов даже в умеренных широтах.
Ледниковый рельеф : Формы земной поверхности, происхождение которых связано с деятельностью ледников или их талых вод.
Ледопад : Участок горного ледника, разбитый на многочисленные трещины и отдельные глыбы, часто меняющие свои формы, в месте крутого перегиба ледникового ложа в русле долины.
Ледоход : Движение льдин и ледяных полей вниз по течению рек, озерам и водохранилищам.
Ледяное сало : Скопление на поверхности воды мелких ледяных игл, образующих при смерзании тонкий ноздреватый слой сероватого, цвета, в виде отдельных сгустков, постепенно соединяющихся в сплошной.
Ледяные поля : Плавающие в водоемах льдины более 20 м в поперечнике.
Ленточные боры : Узкие полосы сосновых лесов с примесью березы и осины по песчаным берегам и гривам вдоль степных и лесостепных рек, преимущественно в Западной Сибири.
Лес галерейный : Смотрите Галерейный лес.
Леса мелколиственные : Листопадные березовые и осиновые леса.
Леса светлохвойные : Наименее требовательные к почвенно-климатическим условиям: сосновые и лиственничные леса, негустая крона которых пропускает солнечные лучи на землю.
Леса смешанные : Леса с различными породами деревьев: хвойно-широколиственные, мелколиственно-сосновые, в тропических широтах.
Леса темнохвойные : Древостой которых представлен видами с темной вечнозеленой хвоей.
Леса широколиственные : Листопадные древесно-кустарниковые сообщества с широкими листьями деревьев в разном сочетании.
Лесная подстилка : Самый верхний почвенный горизонт небольшой мощности из свежеопавших и уже разложившихся листьев, хвои, веток  и других растительных, а также животных остатков.
Лесные ресурсы : Один из важнейших и наиболее разнообразный  вид жизненных ресурсов человечества.
Лесопарк : Вид антропогенного ландшафта.
Лесостепь : Ландшафт, в котором на междуречьях лугово-степные или степные участки чередуются с массивами лесов, «выбирающих» более увлажняемые почвогрунты.
Лесотундра : Субарктический тип ландшафта, в котором на междуречьях угнетенные редколесья чередуются с кустарниковыми или типичными тундрами.
Лёсс : Осадочная горная порода от палевого до желто-коричневого цвета, неслоистая, пористая, состоящая из сцементированной известковистой пыли, тонкозернистого кварца и глины часто с включением «журавчиков».
Линейная эрозия : Размыв земной поверхности постоянными или временными водотоками с образованием протяженных относительно узких рытвин.
Линза : Выпуклое включение горной породы или полезного ископаемого в осадочные слои, чем либо отличающееся от них и выклинивающееся по всем направлениям.
Литогенез : Первые звенья в большом геологическом круговороте веществ, когда осадочная горная порода в процессе сложных преобразований проходит путь от выветривания до метаморфизации и превращения в метаморфическую породу.
Литоральная зона . литораль : Зона морского дна, затопляемая во время прилива и осушаемая при отливе.
Литосфера : Верхняя оболочка Земли выше астеносферы.
Литосферные плиты : Крупнейшие жесткие части  литосферы, дающие основания материкам.
Лог, ложбина : Перешедшая в стадию аккумуляции широкая балка с плоским днищем и пологими склонами, заросшими лесом в лесных и степной растительностью в степных зонах.
Ложе океана : Самый низкий, исключая глубоководные желоба, уровень земной поверхности, расположенный между материковым подножием и срединноокеаническими хребтами.
Лощина : Относительно короткая эрозионная форма рельефа, созданная временными водотоками преимущественно в лесостепных и степных зонах.
Луговая степь : Переходное звено между лесостепью и степью или составная часть лесостепного ландшафта.
Лука : Длинный изгиб реки, или меандра, с оконтуренным полуостровом или мысом, например Самарская Лука на Волге.
Льянос, льяносы : Ландшафт, субэкваториального пояса.
Маары : Цилиндрические или воронкообразные кратеры газового взрыва вулканов без излияния лавы.
Магма : Смесь многочисленных химических соединений и элементов, в том числе летучих, расплавленных до высокотемпературного вязко-жидкого состояния.
Магматические горные породы : Результат застывания магмы.
Майна, или полынья : Пространство чистой воды среди льдов на реке, озере или плавающих в океане.
Маквис, маккия : Заросли вечнозеленых ксерофитных жестколистных и колючих кустарников (обычно 1,5-2,5 м) и невысоких деревьев (до 8-10 м) в странах Средиземноморья, в нижнем поясе гор до высоты 700 м.
Макроклимат : Климат крупнейших территорий, где определяются главнейшие закономерности радиационно-термических и циркуляционных процессов, формирующих зональное распределение ландшафтных типов и направление зонообразующих процессов.
Малые реки. длина малых рек не
более 100 км, площадь бассейна в
пределах 1-2 тыс. км2. располагаются они в
одной географической зоне. большинство рек
земного шара малые; они, подобно : Кровеносным сосудам, питают большие реки, протекающие через несколько географических зон.
Мангровая растительность, мангры : Вечнозеленый тропический интрозональный тип низкорослых лесов и кустарниковых зарослей по низменным, затопляемым в приливы, морским побережьям.
Мантия земли : Внутриземная геосфера между земной корой и ядром.
Марево : Оптическое явление.
Марикультура : Различные формы выращивания обитателей морей.
Марши : Низменная приморская полоса побережья выше ваттов, заливаемая водой только во время высоких приливов и нагонов воды.
Марь : Заболоченное пространство, главным образом на пологих склонах, среди тайги, покрытое либо мелким сфагновым болотом, либо осоково-багульниковыми кочками, поросшее угнетенными карликовыми кустарниками (ерником) и редкостойными лиственницами.
Материковый склон : Часть океанического дна глубже мелководной равнины материковой отмели  от отметки около 200 м и до глубин в 2000 м и более.
Мгла : Сухой туман, помутнение воздуха от взвешенных в нем пыли, дыма и других механических частиц.
Меандры : Повторяющиеся на большом протяжении долины реки изгибы ее русла.
Межгорная впадина : Обширная тектоническая впадина со складчатым, равнинным, оставшимся в покое днищем между поднимающимися хребтами.
Межгорный прогиб : Тектоническая впадина между двумя поднимающимися хребтами в период конечной стадии развития геосинклинали.
Междуречье : Термин, чаще применимый к равнинам,.
Межень, меженный период : Время самого низкого уровня воды в реке при уменьшении стока с водосборной площади летом во время сухой погоды, когда водность реки поддерживают лишь подземные воды, и зимой при ледоставе.
Межледниковье : Промежуток времени между двумя оледенениями в четвертичный период.
Мезозойская складчатость : Развитие геосинклиналей с глубокими прогибами земной коры и накоплением мощных осадков, которые были смяты в складки, подняты в виде гор, прорваны внедрениями гранитной магмы и вулканическими извержениями, продолжавшимися с конца триасового до начала палеогенового периода.
Мезоклимат : Климат отдельных ландшафтов (а в некотооых случаях их частей), например лесного массива в лесостепи, внутригорной впадины, морского побережья в полосе действия бризов, небольшого города и тому подобного.
Мезорельеф : Детали макрорельефа, неровности земной поверхности средних размеров, промежуточных между горами и прирусловым валом или степным блюдцем, то есть между макро и микроформами.
Мезосфера : Средняя часть атмосферной оболочки Земли выше стратосферы на высотах от 50 до 80-85 км.
Мелиорация : Один из способов рационального природопользования, заключающийся в повышении производительной силы земли, ее биопродуктивности или оздоровлении географической среды.
Мелководные отложения : Обломочные и органические отложения в морях и океанах до глубин 200 м, то есть до возможного действия волн и распространения водорослей и животных, которые не могут существовать без солнечного освещения.
Мелколиственные леса : Смотрите Леса мелколиственные.
Мелкосопочник : Термин, закрепившийся за невысокими разрозненными холмами, сложенными коренными (метаморфическими или кристаллическими) горными породами, оставшимися от сильно разрушенных складчатых гор.
Местные ветры : Ветры, отличающиеся какими-либо особенностями от главного характера общей циркуляции атмосферы, но закономерно повторяющиеся и оказывающие заметное влияние на режим погоды в ограниченной части ландшафта или акватории.
Местообитание : Участок суши или акватории, обладающий всеми необходимыми условиями для существования, размещения и развития на нем какого-либо вида растения, животного или всего биоценоза.
Месторождение полезного ископаемого : Природное скопление полезного ископаемого в земной коре, количество и качество которого пригодны для разработки при современной технике и необходимости использования.
Метаморфизация : Эндогенные процессы, существенно преобразующие преимущественно осадочную горную породу в качественно иную, более стойкую и твердую без ее расплавления или растворения.
Метаморфические горные породы : Породы, преобразованные из осадочных и реже из магматических в более стойкие и плотные внутриземными  процессами.
Метель : Перенос снега сильным ветром вблизи земной поверхности.
Миграция : Термин применяется в отношении населения, животных, растений и природных веществ.
Микроклимат : Часть местного климата.
Микроорганизмы : Общее название видимых только в микроскоп мельчайших растительных и животных организмов.
Минерализация воды : Количество растворенных веществ в воде, их состав и степень концентрации.
Минеральные воды : Природные, обычно подземные, воды, имеющие минерализацию более 1 г/л и содержащие специфические микроэлементы, благотворно воздействующие на организм человека.
Минеральные ресурсы : Учтенные запасы месторождений полезных ископаемых какой-либо страны, области и тому подобного.
Мировой океан : Водная часть поверхностного покрова земного шара, исключая сухопутные воды рек, озер и болот.
Многолетняя мерзлота грунтов : Подземное оледенение.
Модуль стока : Количество воды, стекающей с определенной площади бассейна в единицу времени, выраженное в л/с на км2 или м3/с на км2.
Молодые горы : Складчатые горы, образовавшиеся в альпийскую складчатость.
Мониторинг : Система слежения за окружающей природной средой под антропогенным воздействием, помогающая выявить и дать оценку ее состояния, а в дальнейшем и прогноз.
Моноклиналь : Наклон земных слоев в одну сторону, что обычно для осадочных горных пород, прикрывающих склоны платформенных щитов.
Море : Часть океана, вдающаяся в сушу и отделенная от него островами, полуостровами или возвышениями подводного рельефа.
Моренный рельеф : Рельеф, сохранившийся после таяния ледников: грядовый конечных морен, беспорядочно холмистый и увалисгохолмистый на равнинах после таяния покровных ледников, друмлиновый в районах с поверхностным залеганием метаморфических или кристаллических горных пород.
Морены : Рыхлые несортированные горные породы, отложенные или переносимые движущимися ледниками.
Моретрясение : Резкие колебания толщи воды в морях и океанах, возникающие при подводных землетрясениях, эпицентр которых на дне или в прибрежных частях суши.
Морозное выветривание : Разновидность физического выветривания, при котором поверхностная корка каменистых горных пород и скал, расширяясь при оттаивании и сжимаясь при замерзании, трескается.
Морось : Атмосферные осадки, обычно выпадающие из слоистых облаков или тумана в виде мельчайших капелек дождя (диаметр менее 0,5 мм).
Морские отложения : Осадки, накапливающиеся на дне морей и океанов.
Морской климат : Климат, обусловленный особенностями и свойствами воздушных масс, формирующихся над океанами.
Морфология почвы : Строение и внешние признаки почв, которые описываются исследователями в почвенных разрезах: мощность каждого горизонта, их окраска, сложение, структура (комковатая, зернистая, слоистая и тому подобное), включения, новообразования (журавчики, железистые стяжения и другие), наличие пор, корней и главные механические свойства (твердость, плотность) и другие.
Мочажина : Постоянно намокающее понижение рельефа.
Мульда : Обширный, овальный в плане тектонический прогиб земной коры без существенных нарушений и разрывов слоев горных пород.
Муссон : Закономерное, периодически переменное на 120-180°, движение воздушных масс в нижней части тропосферы в зависимости от смены атмосферного давления.
Мутность воды : Степень помутнения из-за содержания в воде твердого вещества.
Мшара : Обсохший или еще болотистый участок верхового сфагнового болота, сплошь покрытый мхами с торфом.
Мыс : Участок побережья, вдающийся в море, озеро или реку в форме острого выступа.
Мягкая вода : Вода с малым содержанием карбонатов кальция и магния (смотрите Жесткость воды).
Мягкий климат : Разновидность морского, при котором нет резких перепадов давления и температур воздуха, сравнительно равномерное распределение атмосферных осадков в году, лето не жаркое, а зима не холодная, позволяющая не иметь меховой или очень теплой одежды.
Наветренный склон : Склон хребта, обращенный в сторону господствующих ветров, что отражается на отличиях в ландшафтах наветренного склона и подветренного.
Наводнение : Затопление водой местности в результате подъема уровня воды в реке, озере или море.
Нагон : Повышение уровня воды ветром.
Нагорные террасы : Гольцовые террасы.
Нагорья : Горная область со сложным соединением хребтов, отдельных горных массивов, плато, межгорных и внутригорных впадин.
Надвиг : Наползание одной группы слоев горных пород (осадочных, метаморфических, реже кристаллических) на другую в процессе интенсивного сжатия при горообразовании.
Надпойменные террасы : Смотрите Террасы.
Наледь : Наросты льда поверх обычного ледяного покрова водотоков и на склонах гор в зонах многолетнемерзлых грунтов.
Напорные воды : Подземные воды в водоносных горизонтах, перекрытых и подстилаемых водоупорными пластами горных пород.
Нарушения тектонические : Смотрите Тектонические движения.
Наст : Твердая ледяная корка на поверхности снега, образующаяся в результате оттепели или смачивания снега дождем и последующего замерзания воды.
Национальный парк : Особое природоохранное учреждение и территория  с рекреационной и просветительной функцией в малонарушенных природных комплексах и уникальными природными объектами (водопадами, каньонами, редкими деревьями и т.
Недра : Часть земной коры от поверхности до центра Земли.
Нектон : Все организмы, активно плавающие в толще воды водоемов, способные противостоять течению и самостоятельно перемещаться на значительные расстояния.
Неотектоника : Новейшие тектонические движения, нарушения и изменения в рельефе земной поверхности, произошедшие за время палеогенового и неогенового периодов и продолжавшиеся в четвертичный период.
Нерестилище : Место икрометания  рыб.
Нерудные полезные ископаемые : Неметаллические и негорючие твердые горные породы и минералы, могущие быть использованными в производственных целях.
Несогласное залегание : Размещение слоев горных пород: 1.
Нивальный климат : Снежный, когда снега выпадает больше, чем успевает растаять.
Нивальный пояс : Вечные снега и ледники.
Нивация : Снежная эрозия, вызывающая образование ниш, каров и цирков.
Низкогорный рельеф, или низкогорье, : Тип резко расчлененного рельефа, в котором не выявляется определенное деление на высотные ландшафтные зоны, за исключением разницы в экспозиции склонов.
Низменность : Участки суши значительных размеров высотой не более 200 м над уровнем океана, например Прикаспийская.
Нитраты : Соли азотной кислоты.
Нулевая поверхность : Раздел  толщи воды в океанах и морях, ниже которого замедляются или вовсе прекращаются горизонтальные течения, что меняет не только динамические и температурные условия, но и состав и количество морских обитателей.
Нунатаки : Одиночная скала или вершина, поднимающаяся над поверхностью ледника и обтекаемая им.
Оазис .
покрытая древесной, кустарниковой и травянистой растительностью местность в пустынях
или полупустынях, где грунтовые или
артезианские воды доступны и достаточны для их
произрастания. оазисы, приурочены к рекам, водохранилищам и проложенным от них
каналам. размеры оазисов от нескольких гектаров
до десятков и сотен гектаров. в них сосредоточено
население, как в долине нила в ливийской пустыне,
ферганской долине в средней азии. на орошаемых
землях развито интенсивное земледелие : Технические и продовольственные культуры и особенно хлопчатник.
Обвал : Смотрите Камнепад.
Обводнение : Увеличение количества и запаса воды в районах с ее недостатком, с целью обеспечения хозяйства и бытовых нужд населения.
Облака : Скопление взвешенных в атмосфере капелек воды или кристаллов льда, появляющихся в результате поднимающихся с земли паров воды и конденсирующихся при охлаждении вверху.
Облесение : Искусственное лесоразведение в целях расширения лесных площадей, восстановления сведенного леса, рекультивации земель, а также один из видов, полезащитной и водоохранной мелиорации.
Обломочные горные породы : Осадочные породы, произошедшие от механического раздробления при выветривании любых других пород и минералов.
Обнажение : Выход коренных горных пород на земную поверхность.
Общая циркуляция атмосферы : Движение воздушных масс в тропосфере и нижней стратосфере.
Овраги : Глубокие, узкие, крутосклонные и вытянутые рытвины, созданные временными водотоками преимущественно в рыхлых, но вязких горных породах.
Огни святого эльма : Электрические разряды в атмосфере, проявляющиеся в виде светящегося пучка на острых концах башен, корабельных мачтах, скалистых вершинах и других объектах.
Озера : Природный водоем с замедленным водообменом, заполняющий впадину суши и закрытый от свободной связи с морем.
Озерность : Отношение суммы водной поверхности всех озер, прудов и водохранилищ к площади суши данного бассейна, области или другого географического региона, выраженное в процентах.
Озерные котловины : Впадины земной коры с замкнутыми в них водоемами.
Озимые культуры : Однолетние растения осеннего посева: рожь, пшеница, ячмень и другие.
Озоносфера : Повышенная концентрация озона (O3) на высоте от 10 до 50 км в стратосфере и особенно в слое 25-35 км с плотностью, в 10 раз большей, чем у земной поверхности.
Озы : Крутосклонные вытянутые от сотен метров до 30-40 км гряды шириной от нескольких метров до 2-3 км.
Окаменелости : Ископаемые остатки древних животных, растений или отпечатки их следов, превратившиеся в каменно-твердое состояние.
Океан : Часть Мирового океана (например, Атлантический, Тихий океан.
Окклюзия циклона : Конечная стадия развития циклона, когда теплые массы воздуха вытесняются холодным фронтом в верхние слои тропосферы.
Окружающая среда : Среда обитания, производственной деятельности и отдыха человечества или отдельного коллектива, семьи.
Омоложение рельефа : Усилившееся расчленение рельефа при тектонических движениях, опускании базиса эрозии или повышении влажности климата.
Омут : Глубокая яма в глубоком месте в озере или русле реки, высверленная водоворотами или течением.
Оплывина : Смещение по склону маломощной полосы почвогрунтов при переувлажнении.
Оползень : Отрыв и сползание под влиянием силы тяжести вниз по склону рыхлого или плотного блока горной породы без существенного нарушения структуры сползшей части.
Ополья : Возвышенные безлесные пространства в южной части лесных (тайги, широколиственных) зон на Восточно-Европейской равнине.
Опреснение морской воды : Способ обработки воды с целью уменьшения содержания в ней солей до степени пресной воды, пригодной для хозяйственно-питьевого водоснабжения.
Опустынивание : Расширение площадей пустынь и наступление их на степи, саванны и другие ландшафты.
Органогенные горные породы : Осадочные отложения, состоящие из отмерших остатков растений, животных или продуктов их жизнедеятельности.
Орография , или морфометрия, : Описания форм рельефа по внешним признакам и взаимному расположению.
Орошение, или ирригация : Искусственное увлажнение почвы путем подвода воды на земли, испытывающие недостаток влаги в корнеобитаемом слое.
Осадкообразование : Процесс накопления минеральных и органических осадков в морской (морские осадки), континентальной и водной (речные, болотные, озерные, эоловые и других) средах.
Осадочные горные породы : Породы, образованные наносами.
Осередок : Скопление наносов в русле реки в виде невысоких затопляемых или частично обнаженных отмелей либо меняющих место островов продолговатой, вытянутой формы.
Основные горные породы : Интрузивные (габбро, диабазы, нориты и другие) и эффузивные (базальты, андезиты, липариты) магматические породы, недонасыщенные кремнекислотой (кремния 44-53%) и высоким содержанием железа и алюминия, магния и кальция.
Останцы : Обособленно стоящие возвышенности, уцелевшие от разрушения более обширной территории того же или более высокого уровня.
Остров : Участок суши в море, озере или реке, окруженный водой.
Островные горы : Группы или отдельные повышения (от 100 до 2000 м) среди равнинных территорий.
Островные дуги : Гирлянды островов, поднимающихся от массивных (шириной от 40 до 400 км) подводных хребтов.
Осушение : Вид мелиорации, проводимой преимущественно в избыточно влажных ландшафтных зонах  для удаления мешающей производственной деятельности поверхностной или почвогрунтовой воды.
Осыпи : Неокатанные обломки (продукты выветривания) горных пород размерами от песка, щебня и до метровых глыб, скользящие по склонам (в основном круче 30°) под действием силы тяжести и скапливающиеся у подножий в виде конусов, расширенных внизу и лишенных постоянной растительности.
Отвалы : Нагромождения горных пород, не использованных при добыче полезных ископаемых.
Отдельность : Постоянная (характерная) форма разного происхождения кусков горной породы, отвалившихся в процессе выветривания или откалываемых исследователями.
Отрицательные формы рельефа : Понижения земной поверхности, исчисляемые не только в абсолютных, но и в относительных высотах: впадины, долины, воронки, котловины, овраги, промоины, в том числе в микрорельефе и на морском дне.
Отрог горного хребта : Более короткий, низкий, второстепенный хребет, отходящий под углом от главного.
Оттепель : Теплая погода среди зимы, когда тает снег, в умеренных и высоких широтах.
Охрана окружающей среды : Обширная система мероприятий, направленных на исключение бессмысленной или нерациональной порчи, на поддержание и увеличение продуктивности ландшафтов или их компонентов, на обязательное рациональное природопользование.
Охраняемые виды : Виды животных и растений, уничтожение особей которых, так же как и порча среды их привычного обитания, запрещено государственными, местными или международными органами.
Паводок : Резкий и кратковременный подъем уровня воды в реке, увеличение расхода воды, возникающее в результате обильных дождей, интенсивного таяния снега, ледников, залповых сбросов воды из водохранилищ.
Падение реки : Разность отметок высот поверхности воды в двух точках, расположенных на некотором расстоянии вдоль течения реки.
Падь : Горная глубокая долина, ложбина и межгорное понижение, образованные временными (реже постоянными) водотоками в горных районах Сибири и Дальнего Востока.
Пак : Многолетний морской лед, выдержавший минимум 2 годовых цикла нарастания и таяния, голубого цвета, толщиной 3-5 м.
Пампа, пампасы : Субтропические степи на лёссовых равнинах Южной Америки, главным образом в Аргентине и Уругвае.
Памятник природы : Уникальное, редкое и выдающееся творение как живой, так и неживой природы.
Парма : Невысокие хребты и увалы, протянувшиеся параллельно западному склону Приполярного и Северного Урала, покрытые елово-пихтовыми лесами с густым моховым покровом.
Пассатные течения : Поверхностные океанические течения со скоростью 0,2-1 м/с в тропических и экваториальных широтах с востока на запад, вызываемые пассатами.
Пассаты : Постоянный круглогодичный перенос воздушных масс от субтропических областей (25-30° северной и южной широты) высокого атмосферного давления навстречу друг другу в область низкого атмосферного давления над экватором.
Пахотный слой почвы : Обрабатываемый поверхностный слой почвы для получения урожая.
Пелагиаль : Пелагическая область.
Пенеплен : Смотрите Поверхности выравнивания.
Перевал : Место в горном хребте, пониженное и наиболее удобное для перехода с одной его стороны на другую.
Перекат : Мелководный участок русла реки в виде вала, подводной гряды с пологим скатом, обращенным против течений, и крутым.
Перелесок : Редкостойный лес в окружении густого, а также небольшой его участок, отделенный от главного массива полянами.
Пересыпь : Узкая низкая наносная полоса песка и гальки (коса), отделяющая от моря лиман или лагуну.
Перехват реки : Захват энергично врезающейся рекой (пятящаяся эрозия) части соседней реки, долина которой расположена гипсометрически выше первой.
Перешеек : Узкая полоса суши, соединяющая два крупных ее участка и разделяющая акватории или два водных бассейна, например Перекопский перешеек между Азовским и Черным морями, Карельской перешеек между Ладожским озером и Финским заливом, Панамский перешеек между Тихим и Атлантическим океанами, но соединяющий два материка Америки.
Песчаная буря : Смотрите Пыльная буря.
Пещера : Полость в поверхностных толщах земной коры различной формы и размеров, сообщающаяся с поверхностью одним или несколькими отверстиями.
Питание реки : Приток воды в реку (водоток) от разных источников.
Плавни : Заболоченные поймы в устьях, дельтах, зарастающие старицы крупных рек на юге России, заливаемые полыми водами, где господствуют влаголюбивые тростниковые заросли с рогозом и камышом, встречаются участки пойменных лесов.
Плавник : Выброшенные на берег прибоем моря или течением реки стволы деревьев или разрушенных построек.
Плакор : Широкое приводораздельное пространство, где при глубоком залегании подземных вод поверхностный смыв и тем более отложение новых напластований не нарушили типичных зональных черт почвенного или почвенно-растительного покрова.
Планация : Выравнивание рельефа.
Планктон : Растительные (фитопланктон) и животные (зоопланктон) водные организмы во взвешенном состоянии, пассивно передвигающиеся вместе с водой в морях, озерах и реках.
Пласт : Часть осадочной или метаморфической горной породы с однородными признаками (цветом, крупностью зерен или частей, плотностью, влажностью и т.
Плато : Равнинные или слегка волнистые пространства, возвышающиеся над окружающей местностью с хорошо выраженными склонами или обрывами.
Платформа : Обширные малоподвижные участки земной коры.
Плёс, или плесо : 1) участок реки между перекатами, с ровным течением, с плоским дном или у вогнутого берега, где в половодье интенсивно размывается дно.
Плита : Глубоко глубоко опущенные складчато-метаморфические основания платформ с очень мощным (до 10-16 км) осадочным покровом – верхним ярусом (Западно-Сибирская, Туранская).
Плодородие почвы : Способность почвы обеспечивать растения усвояемыми питательными веществами и влагой.
Плоскогорье : Массивное средневысотное горное поднятие (500-1500 м) с общирными плоскими, равнинными междуречьями и глубоко врезанными долинами.
Плывун : Насыщенные водой пылеватые горные породы (мелкозернистый песок, реже суглинок), способные перемещаться (расплываться) при вскрытии вышележащих толщ, что зависит от жизнедеятельности микроорганизмов.
Побережье : Полоса суши, примыкающая к морскому или озерному берегу и испытывающая их климатическое влияние, а в рельефе сохраняющая следы как современных, так и древних форм водного воздействия.
Поверхности выравнивания : Возвышенные (пенеплены) равнины, образующиеся как на платформах, так и в горах там, где процессы денудации опережают процессы тектонических подъемов.
Поглощенная радиация : Смотрите Солнечная радиация.
Погода : Состояние приземного слоя атмосферы в каждом данном районе за какой-либо срок (сутки, месяц, год, но многолетняя характерная погода называется климатом).
Подветренная сторона : Склоны хребтов, горных массивов и плато, расположенные на противоположной стороне к господствующим ветрам.
Подводные долины : Затопленные речные долины на шельфе или материковой отмели.
Подводные хребты : Мощные среднеокеанические поднятия, протягивающиеся вдоль всех океанов и соединяющиеся друг с другом.
Подводный каньон : Подводные долины, формы рельефа материковой отмели и материкового склона.
Подземные воды : Важное полезное ископаемое, расположенное в верхней толщине земной коры в жидком, твердом и парообразном состоянии.
Подземные реки и озера : Водотоки и водоемы, встречающиеся почти везде в местах распространения карста в пещерах и трещинах.
Подземный сток : Процесс передвижения подземных вод от областей питания к местам их разгрузки под действием гидравлического напора.
Подзона ландшафтная : Часть географической зоны.
Подлесок : Кустарники и низкие деревья, никогда не вырастающие до высоты основных лесообразующих пород древостоя.
Подошва, или подножие гор : Узкая полоса вдоль горного склона, переходящего заметным перегибом к плоской или наклонной равнине.
Подпор воды : Повышение уровня воды в притоках, когда на главной реке проходит волна паводка или половодья, а также при резких сужениях и крутых поворотах русла, зажорах, обвалах или искусственных сооружениях, в том числе и бобровых плотинах.
Подстилающая поверхность : Разнообразные компоненты земной поверхности, взаимодействующие с атмосферой и влияющие на ее состояние.
Подтопление : Повышение уровня грунтовых вод, связанных с сооружением плотин и подпором их речными водами.
Позёмок, позёмка : Перенос снега ветром у самой поверхности снежного покрова; одна из разновидностей метели.
Пойма : Часть дна речной долины, заливаемая водой в половодье и паводки,.
Пойменные луга : Травяная растительность, развивается на поймах.
Полезащитные лесные полосы : Один из видов мелиорации.
Полезные ископаемые : Природные минеральные образования в земной коре неорганического и органического происхождения, которые при данном уровне развития экономики и техники могут быть использованы в народном хозяйстве в естественном виде как сырье или после соответствующей переработки.
Полесья : Полесские ландшафты переувлажненных равнин в пограничной области природных зон южной тайги, смешанных и широколиственных лесов.
Полигональные грунты : Широко распространенный мезо- и микрорельеф, типичный для областей с многолетнемерзлыми или глубокопромерзающими почвогрунтами и особенно в тундре и тундролесьях.
Половодье : Наибольшая в году водность реки, когда проходит значительная часть годового стока , затопляется пойма, а иногда и низкие террасы.
Полонина : В Карпатах субальпийские луга выше границы леса, пастбище.
Полукустарники : Растения, в которых нижняя часть представляется многолетним одервенелым стволиком, а верхняя травянистая ежегодно отмирает.
Полуостров : Глубоко вдающийся в море участок материка или острова, окруженный с трех сторон водой, с четвертой соединенный с сушей.
Полупустыни : Тип ландшафта, промежуточный между степью и пустыней в умеренных географических поясах и между саванной и пустыней в тропических, с соответствующими смешениями растительности, животных и почв.
Полынья : Место с открытой водой среди замерзшей поверхности реки, озера, моря.
Польдеры : Низменное побережье Северного моря в Нидерландах, Дании, ФРГ обычно ниже уровня моря, осушенное и защищенное от затопления дамбами при постоянных мероприятиях понижения грунтовых вод.
Полья : Замкнутые понижения, котловины большой площади (до сотни квадратных километров), образованные карстовыми явлениями.
Полюсы холода : Области с наименьшими температурами данного полушария.
Полярное сияние : Эффективное быстро меняющееся ленто- и дугообразное свечение голубовато-белого, желто-зеленого, реже фиолетового и красноватого цвета атомов кислорода и молекул азота в разреженном воздухе магнитного поля Земли.
Полярный воздух : Воздушные массы, формирующиеся над сушей или океанами в субарктическом, субантарктическом и умеренных географических поясах, то есть во внетропических широтах.
Понор : Округлое отверстие (трещина) на поверхности карстующих горных пород, по которой уходят вглубь дождевые, талые снеговые, проточные воды.
Поозерье : Озерно-холмистый ландшафт, характерный для краевой зоны древнего оледенения (последней валдайской фазы) на северо-западе, в Прибалтике, в Польше (Белорусско-Валдайское поозерье, Мазурское, Поморское, Мекленбургское поозерья).
Популяция : Исторически сложившиеся родственные группы какого-либо вида животных или растений, занимающих определенное местообитание в части ареала общего для всего вида.
Порог : Мелководный каменистый участок реки на трудноразмываемых горных породах или валунах с большим перепадом  течения.
Породообразующие минералы : Преобладающие и постоянные составные минералы в горной породе, по которым определяется происхождение и наименование ее.
Почвенная вода : Вода во всех формах движения и взаимосвязи с минерально-органической, составляющей почву данного участка.
Почвенный воздух : Воздух, заполняющий поры и пустоты почв, не занятые водой.
Почвенный горизонт : Слой, формирующийся в результате расчленения почвы в процессе ее образования, поэтому такие слои называются генетическими и располагаются один над другим.
Почвенный профиль : Вертикальный разрез почвы от ее поверхности до материнской породы, где ясно прослеживаются сформировавшиеся в почвообразовательном процессе генетически взаимосвязанные почвенные горизонты и подгоризонты.
Почвенный раствор : Вода с растворенными в ней газами, минеральными и органическими веществами, попавшими в почву из атмосферы, и обогащаемая ими при просачивании через почвенные горизонты.
Почвогрунты : Динамическое и геохимическое объединение почв с подстилающими грунтами, на которых они формируются с общей мощностью от 2-3 до 7-10 м.
Почва и ее типы : Верхний тонкий слой земной коры , покрытый растительностью и обладающий плодородием,.
Предгорный прогиб : Смотрите Краевой прогиб.
Предгорья : Полоса ландшафтов, переходная между горами (горные системы, хребты, крупные массивы) и равнинами.
Предельно допустимые концентрации : Наибольшее количество вредных веществ в единице объема воздуха или вод, не вредящих здоровью людей и окружающей среде с ее фауной и флорой.
Преобразования природы : Мероприятия по рациональному использованию природной среды и сохранению экологического равновесия.
Прерии : Степные равнины Северной Америки, в прошлом покрытые высокотравной растительностью с преобладанием злаков: ковыль, бородач, бизонова трава, пырей, тонконог на черноземовидных почвах.
Прибой : Волны, набегающие у берегов и разрушающиеся при выходе на мелководье.
Приземный слой воздуха : Нижний слой тропосферы , на который оказывает влияние подстилающая поверхность: холмы, долины озерами, кроны леса, городские постройки и тому подобное.
Прилавки : Местное название предгорий среднеазиатских гор, форма которых представлена резкими, часто ступенчатыми обрывами и относительно равнинной поверхностью.
Приливно-отливные явления : Периодические подъемы и опускания уровня океанов и морей, вызываемые силами притяжения Луны и Солнца (в 2,2 раза меньше лунной), действующими также и на изменение атмосферного давления и деформацию твердого вещества Земли.
Припай : Полоса неподвижного морского льда, смерзшаяся с берегом и подводным береговым склоном.
Природопользование : Использование богатств Земли, каждого ландшафта и его частей в отдельности для существования человечества вообще и каждого его коллектива для его хозяйствования, культурных и оздоровительных целей.
Прирусловый, или прирусловой вал : Вытянутый вдоль русла реки аллювиальный.
Приток : Водный поток , впадающая в другой, более крупный водоток или водоем (озеро).
Пролив : Узкое водное пространство, разделяющее сушу (между материками, островами или между материком и островом) и соединяющее смежные водоемы.
Пролювий, пролювиальные отложения : Рыхлые отложения продуктов разрушения горных пород, смываемых и выносимых по ложбинам (эрозионным бороздам) временными потоками от атмосферных осадков к подножию возвышенностей (гор).
Просадки : Прогиб, опускание, оседание грунтов.
Простирание пласта или слоя горной
породы, а также жилы определяется
горным компасом относительно стран света
 по линии, проведенной горизонтально
по плоскости пласта : Пересечение пласта с плоскостью.
Противотечение : Морское течение против господствующих ветров или против постоянного течения, что вызывается местными особенностями, например большим уровнем приливов и отливов.
Профиль, в географии и геологии : Вертикальный разрез, или пересечение территории, формы рельефа , или свиты геологических пластов.
Профиль склона : Формирование склонов долин и гор зависит от глубинной эрозии и денудации, от горных пород и расположения их слоев, от растительности и климатических особенностей, все это имеет практическое значение при любом природопользовании (размещении населенных пунктов, пашен, сенокосов и тому подобного).
Пруд : Водохранилище небольшого размера , образуемое перегораживанием русла малой реки, ручья, балки, оврага, а иногда созданием котлована (копань) глубиной 3-5 м.
Прямая радиация : Смотрите Солнечная радиация.
Псаммофилы : Животные песков, хорошо приспособленные к своеобразным пустынным условиям местообитания на песке или в его толще.
Псаммофиты : Растения подвижных песков.
Птичий базар : Массовое гнездовье колониальных морских птиц на прибрежных обрывистых скалах, главным образом в Арктике и Антарктике.
Пуна : Высокогорные (3500-4600м) пустыни и полупустынные сухие степи в Центральных Андах Южной Америки между 8-29° южной широты.
Пустошь : Невозделанный или заброшенный участок земли с очень бедными почвами в лесной зоне, лесотундре или верхних поясах гор.
Пустынный загар : Понятие, связанное с цветом и способностью образующейся в пустынях защитной корки предохранять горные породы от выветривания.
Пуща : Густой лес, непроходимая лесная чаща, дебри, крупный массив заповедного леса.
Пыльная буря : Сильный ветер типа суховея, выдувающий и переносящий на большие расстояния огромные массы мелкоземистых частиц почвы, а в пустынях песка.
Пьяный лес : Деревья с наклоненными, кривыми или изогнутыми стволами в связи с подвижками почвогрунтов во время их роста.
Равнины : Самый распространенный тип рельефа на земной поверхности (на суше площадь равнин занимает около 20%) и на дне океанов с малыми, не более 200 м, колебаниями относительных высот при пологих (до 5°) их склонах.
Радиация : Смотрите Солнечная радиация.
Радуга : Оптическое явление в атмосфере в виде разноцветной дуги на небосводе на фоне завесы дождя, расположенной в противоположной стороне от Солнца.
Разводье : Пространство открытой воды в ледяном покрове, образующееся в результате подвижек льда под действием ветра или приливно-отливных течений.
Разломы : Крупнейшие тектонические нарушения, сопровождающие горообразование, сводовые поднятия земной коры или начало раздвижения плит (смотрите Тектоника плит и рифт).
Разнотравье : Обычно луговые травы, но не содержащие злаковых, бобовых и осок.
Рапа : Крепкий соляной раствор минеральных озер, лиманов, из которого получают соль.
Рассеянная радиация : Смотрите Солнечная радиация.
Рассоление почвы : Процесс удаления из почвы водорастворимых солей.
Расход воды в реке : Объем воды, протекающий через живое сечение потока в единицу времени.
Регрессия : Постепенное отступание моря от берегов при поднятии суши или опускании его дна.
Редкие металлы : Рассеянные в земной коре, встречающиеся почти исключительно в составе других руд, не образующие собственных крупных залежей что осложняет их извлечение из горной породы.
Редколесья : Редкостойный лес с несомкнутыми кронами деревьев.
Режим рек : Ход многолетних, сезонных и суточных изменений речного потока в его русле.
Резкоконтинентальный климат : Климат территорий, удаленных от смягчающего влияния океанов,.
Река : Водный поток постоянный, в засушливых зонах временно пересыхающий, питающийся дождевыми, снеговыми, ледниковыми и подземными водами и текущий в разработанном им русле.
Рекреационные территории : Восстановление израсходованных в процессе труда физических и духовных сил.
Рекультивация земель : Мероприятия по восстановлению биологической продуктивности и эстетической ценности ландшафтов, утраченных в процессе производства или стихийных бедствий.
Реликты : Животные или растения, сохранившиеся от прошлых геологических эпох.
Рельеф : Неровности сухопутной и подводной земной поверхности.
Рифты : Крупнейший разлом при горизонтальном растяжении земной коры, сопряженный со сводовым ее подъемом, протяженностью в сотни и тысячи километров.
Рифы : Подводные скалы, отмели, косы, малоподнимающиеся над уровнем водоема, моря, препятствующие судоходству.
Ропак : Отдельная льдина, стоящая вертикально среди относительно ровной поверхности сплошного ледяного покрова на море или на реке.
Роса : Атмосферные осадки в виде мелких капелек воды на поверхности земли, предметах, растениях как результат конденсации пара, охлажденного ночным излучением.
Россыпные полезные ископаемые : Включения рудных минералов в промышленных концентрациях в россыпях (золото, алмазы, касситерит и др.
Роща : Небольшой, обычно лиственный лес, обособленный от крупных лесных массивов.
Рукав : Ответвление русла реки или отделившееся русло, но вновь впадающее в ту же реку ниже по течению.
Русло : Самая низкая часть речной долины, выработанная и занятая водным потоком, по которой перемещается основная часть донных наносов и сток воды в межпаводочные периоды.
Ручей : Небольшой постоянный или временный водный поток, по руслу которого стекают дождевые, талые или выходящие на поверхность подземные воды.
Рытвина : Крутосклонное углубление, выбитое на дорожной колее; углубленная дождями борозда на поле или вырытая ливнями на каком-либо склоне.
Рям : Моховое сфагновое болото, поросшее кустарником, низкорослой угнетенной сосной или кедром в зоне южной тайги и лесостепи Западной Сибири и Приуралья.
Саванна : Зональный тип ландшафта тропических и субэкваториальных поясов, где ясно выражена смена влажного и сухого сезона года при неизменно высоких температурах воздуха (15-32°С).
Сай : Сухие русла временных водотоков, а также галечные наносы пересыхающих рек, балки, овраги в пустынных районах Средней Азии и Казахстана.
Самум : Знойный сухой ветер («дыхание смерти» у местных жителей) в пустынях Аравийского полуострова и Северной Африки, несущий раскаленный песок и пыль.
Сапропель : Гнилостный ил озер и лагун из отмерших частей планктона и бентоса с примесью частиц глины, песка.
Сахель : Переходная ландшафтная зона между пустынями Северной Африки и саванной шириной 300-500 км.
Сброс : Смещение слоев горных пород при тектонических движениях по вертикальной или крутонаклонной трещине.
Светлохвойный лес : Смотрите Лес светлохвойный.
Свечение моря : Вызывается морскими организмами, обладающими органами, излучающими свет: черви, медузы, некоторые рачки и рыбы.
Сводовое поднятие : Крупная как по протяженности, так и по высоте выпуклость земной коры.
Сгонно-нагонные явления : Воздействие ветров на водную поверхность морей, озер, водохранилищ, рек (особенно в устьях), повышающих иногда до 2-5 м их уровень у берегов (нагон) и соответственно сгон в подветренной части.
Сдвиг : Смещение крупных блоков земной коры в горизонтальном направлении в результате тектонических движений, по вертикальной или наклонной трещине разлома.
Североамериканский, или канадский антициклон : Область высокого атмосферного давления, возникающая зимой вследствие выхолаживания крупного материка Северной Америки с центром над Кордильерами.
Седиментация : Процесс перехода переносимых воздухом или водой подвижных материалов выветривания, денудации, в неподвижное состояние слоистых отложений.
Сезонная мерзлота : Промерзание почвогрунтов за холодный сезон года, в том числе с образованием ледяных включений, которые оттаивают за лето.
Сейсмические области : Территории, подверженные землетрясениям.
Сейсмические пояса земли . выделяются два
обширных пояса : Тихоокеанский и Средиземноморско-Трансазиатский.
Сейши : Вертикальные колебания воды в озерах и полузамкнутых морских заливах от сейсмических толчков, резкой смены атмосферного давления (на поверхности воды), интенсивного выпадения атмосферных осадков в одной части водоема или шквалистых ветров и так далее.
Сель : Грязекаменный или грязевой поток по руслам горных рек или падей, возникающий во время сильных ливней, интенсивного снеготаяния, реже при вулканических извержениях.
Сельва : Бразильское название влажных, периодически затопляемых лесов экваториального пояса (гилей) в Южной Америке, в основном в бассейне Амазонки.
Сельги : Общее название сухих гряд , распространенных в бассейне Балтийского моря с преимущественным северо-западным простиранием.
Семиаридный климат : Полусухой климат с атмосферными осадками, не обеспечивающими произрастание деревьев на водораздельных пространствах, а часто и не обеспечивающими нормальное развитие сельскохозяйственных культур.
Семигумидный климат : Полувлажный климат, типичный для лесостепей и северной части субтропического пояса, особенно во внутриконтинентальных частях, но еще имеющих лесную растительность, например саванн.
Сибирский антициклон : Смотрите Азиатский антициклон.
Силикаты : Самая многочисленная группа кремнекислородных минералов (более 500), составляющая около 80% массы земной коры.
Синеклизы : Крупнейшие, но пологосклонные прогибы в платформах протяженностью в сотни километров.
Синклиналь : Вогнутая складка слоев горных пород, в центре которой залегают более молодые отложения, чем на ее крыльях.
Сирокко : Жаркий, сухой, пыльный южный и юго-восточный ветер из пустынь Северной Африки и Аравийского полуострова, возникающий в передней части циклона.
Сквозная долина , или долина
прорыва : Резкое сужение речной долины при пересечении ею горного хребта или крупной возвышенности.
Скелетная почва : Содержащая обломки плохо выветрелых горных пород и минералов размером более 3 мм, образующих ее скелет.
Складкообразование : Изгиб горизонтально залегающих (еще не затвердевших) слоев горных пород при тектонических движениях в земной коре.
Складчато-глыбовые горы : Горы и горные области, возникающие при повторных тектонических движениях, когда потерявшие пластичность и затвердевшие складки горных пород подвергаются разломам на крупные блоки земной коры, которые либо поднимаются, образуя горсты, либо опускаются в виде грабенов.
Складчатые горы : Первичные поднятия при изгибе земных слоев тектоническими движениями преимущественно в геосинклинальных областях, в океанических глубинах.
Склоны : Самые распространенные формы поверхности земной коры.
Скрэб : Заросли низкорослых  вечнозеленых ксерофитных кустарников в субтропической и отчасти тропической юго-западной и центральной частях Австралии.
Скульптурный рельеф : Формы рельефа с относительно небольшими превышениями отдельных частей.
Сланцеватость : Способность многих горных пород (глинистые, углистые, карбонатные, слюдистые, амфиболиты и другие) при ударах раскалываться на тонкие пластинки, что обусловлено параллельным распределением в них минералов в процессе накопления слоев или при сильном давлении вышенакопленных отложений, а также при интенсивной метаморфизации кристаллических горных пород (гнейсы).
Слоистость : Смотрите Горизонтальная слоистость.
Смерч : Сильнейший атмосферный вихрь в центральной части стремительно развивающегося циклона.
Смог : Загрязнение приземного слоя воздуха в больших городах смесью дыма и газовых отходов предприятий и транспорта.
Снеговая линия, снеговая граница : Уровень, выше которого в горах сохраняется нетающий снег, превращающийся постепенно в фирн, а потом и в лед горных ледников.
Снежник : Скопление снега и льда, сохраняющегося дольше обычного снежного покрова или в течение всего года.
Соленость морской воды : Общее количество всех растворимых минеральных веществ (солей) в морской воде, выражающееся в единицах промилле, то есть весовых частях солей, приходящихся на 1000 весовых частей воды, и обозначается °/оо.
Солифлюкция : Процесс поверхностного сползания переувлажненных мелкоземистых почвогрунтов.
Солнечная радиация : Электромагнитное и корпускулярное излучение Солнца.
Солонцы : Тип засоленных почв, в которых легкорастворимые соли  во вредных для растений количествах находятся на некоторой глубине (20-50 см и глубже), образуя очень плотный столбчатый солонцовый горизонт.
Солончаки : Тип засоленных почв, в которых легкорастворимые соли во вредных для растений количествах содержатся в поверхностном слое, в виде выцветов, корочек или пухлых горизонтов.
Соляные купола : Вспучивание слоев осадочных пород, если под ними на глубине 300-1000 м залегают мощные отложения каменной или калийной соли.
Сомма : Полуразрушенный гребень древнего вулкана, уцелевший после нового взрыва и полуокружающий вновь возникший вулкан, например в Авачинском на Камчатке или у Везувия.
Сопка : Общее название невысоких гор с округлыми вершинами или высоких холмов, широко распространенное в Сибири, Казахстане (мелкосопочник); в археологии.
Сплавина, зыбун : Плавучий «ковер» из камыша, рогоза, вахты и других корневищных растений, а также сфагновых и зеленых мхов по краям зарастающего водоема.
Средиземноморский климат : Разновидность субтропического климата на западных окраинах континентов Евразии, Африки, Америки и Австралии, отличается мягкостью в связи с отепляющим влиянием адвекции океанического воздуха.
Средневысотные горы, или среднегорье, : Форма рельефа, типичная для старых гор, определяемая абсолютными высотами от 1000 до 3000 м и относительным расчленением  от 500 до 2000 м.
Средняя температура воздуха : Важный элемент характеристики климата каждого района.
Сталагмит : Известняковые, гипсовые или соляные бугорки, конусы и даже столбы на дне карстовых пещер, нарастающие снизу вверх.
Сталактит : Висячие натечные, обычно известковые образования, нарастающие вниз с потолков карстовых пещер или пустот горных пород, подобно ледяным сосулькам, или бахромы, гребенок и других форм.
Стамуха : Лед, остановленный в движении и оставшийся на мели у берегов или на банках.
Старица, староречье, старичка, старка : Озеро на пойме или на нижней надпойменной террасе.
Старые горы : Горы, созданные древними горообразовательными процессами  и долго не переживавшие повторных подъемов (Южное Забайкалье, Казахский мелкосопочник и другие).
Стрежень : Линия наибольших скоростей течения в реке.
Стланики : Форма низкорослых приземистых растений.
Стоковые ветры : Движение переохлажденного, а значит, утяжеленного воздуха под действием силы тяжести с возвышенностей в понижения, в том числе с поверхности ледниковых покровов  к более теплым океанам.
Столбчатая отдельность : Смотрите Отдельность.
Столовые горы : Отчлененные тектоническими разрывами или размывом (экзогенными процессами) от высокого плато, а иногда и стоящие отдельно плосковершинные возвышенности с обрывистыми или крутыми склонами.
Сточные воды : Воды, удаляемые системой канализации с территорий населенных пунктов и промышленных предприятий.
Стратификация : Смотрите Температурная стратификация.
Стратосфера : Слой атмосферы на высоте от 8 до 55 км над Землей, в который постепенно переходит тропосфера на высоте 8 км над полюсами и от 18 км над тропиками.
Структура почвы : Важный для плодородия и агропроизводства элемент строения почв.
Структурный рельеф : Рельеф, полностью зависящий от геологического строения.
Субальпийские луга : Коренная растительность приморских и умеренно-континентальных гор, образующая хорошо выраженный высотный пояс , переходный от луговых полян высокогорного редколесья к альпийскому низкотравью.
Субарктический климат : Тип климата, сформировавший субарктический географический пояс.
Сублимация : В метеорологии образование ледяных кристаллов (иней) сразу из водяных паров без перехода их в воду или быстром их охлаждении ниже 0°С в то время, когда температура воздуха еще держится выше этого радиационного охлаждения, что случается в тихие ясные ночи в холодную часть года.
Субэкваториальные пояса : Два природных географических пояса, оконтуривающие экваториальный в Южной Америке, Африке и острова Индонезии.
Суккуленты : Засухоустойчивые растения (ксерофиты), способные накапливать в запас влагу и долго хранить ее, замедляя испарение, для своего сохранения в сухой период года.
Сумерки : Плавный переход от светлого времени суток к ночи вечером и обратно утром.
Суммарная радиация : Смотрите Солнечная радиация.
Суффозия : Образование просадочных блюдец, впадин, воронок на поверхности почвогрунтов в связи с выщелачиванием (растворением) и выносом грунтовыми и просачивающимися сверху водами мелких минеральных частиц или при возникновении подземных пустот, вызывающих просадки верхних слоев осадочных напластований.
Суховей : Иссушающий ветер со скоростью от 5 до 20 м/с, исходящий от периферии антициклонов летом преимущественно при вторжении тропических масс воздуха (аналоги хамсин, сирокко и других).
Сухой сезон : Ежегодно повторяющееся в течение нескольких месяцев уменьшение и даже прекращение атмосферных осадков в субэкваториальных, тропических географических поясах и в средиземноморском регионе субтропического пояса, что вызывается смещением антициклонов вслед за переходом Солнца через экватор.
Тайфун : Название тропических циклонов.
Талик : Участок талого грунта среди толщи многолетнемерзлых грунтов.
Тальвег : Линия, соединяющая самые низкие (глубокие) точки дна долины или русла реки, оврага или балки, ледника, ложбины, лощины и других эрозионных форм рельефа.
Тарын : Многолетняя крупная наледь преимущественно от грунтовых вод.
Твердый сток : Масса взвешенных тонко и мелкозернистых влекомых  по дну и растворенных химических и биогенных веществ, которые сносятся поверхностным стоком в реки, а также породы, отторгнутые водой от русла и берегов.
Текстура : Особенности сложения, строения горных пород с характерным закономерным расположением частей, составляющих каждую породу, то есть каким способом ее масса заполнила пространство.
Тектоника плит : Гипотеза  о медленном передвижении разъединенных частей литосферы по поверхности астеносферы.
Тектоническая долина : Речная долина, протянувшаяся вдоль грабена, разлома, зоны тектонического дробления или по синклинали, то есть обусловлена тектоническими движениями.
Тектонические движения : Различные нарушения покоя и целостности земной коры внутриземными силами, приводящими к существенным изменениям форм ее поверхности.
Темнохвойный лес : Смотрите Лес темнохвойный.
Тепловые пояса : Широкие полосы, опоясывающие Землю, с близкими температурами воздуха внутри пояса и отличающиеся от соседних неоднородным широтным распределением прихода солнечной радиации.
Теплый фронт : Восходящее скольжение теплой воздушной массы по пологой наклонной массе почти неподвижного холодного воздуха.
Термальные воды : Подземные воды с температурой выше 20° С, нагретые теплом глубинных зон земной коры.
Термокарст : Типичное и широкораспространенное явление в зоне многолетнемерзлых почвогрунтов, связанное с вытаиванием подземного льда.
Термосфера : Разреженный слой атмосферы между высотами 80 и 300 км, то есть выше границы мезосферы (мезопауза).
Террасы : Выровненная площадка на склоне гор, речных долин, морских и озерных берегов.
Терригенные отложения : Обломочный материал, образованный в результате выветривания, эрозии и денудации из больших и малых частиц различных горных пород и минералов суши.
Технические культуры : Растения, используемые как промышленное сырье.
Техногенный рельеф : Созданный человеком при инженерных работах и добыче полезных ископаемых: дорожные насыпи, дамбы для предотвращения наводнений, каналы, террассированные склоны гор при дорожном строительстве или использовании под культуры.
Течения океанические : Движение водных масс, возбуждаемые многими, большей частью совмещенными причинами.
Толтры : Сложенные известняками скалистые и островершинные холмы в западной части Подольской возвышенности.
Топь : Сильно переувлажненный участок болота с разжиженной торфяной залежью и непрочной рыхлой растительной лепниной.
Торнадо : Американское название смерча, отличающегося в США большой повторяемостью (по сравнению с европейскими).
Торосы : Нагромождение вздыбленных обломков льдин в морях, реках и озерах в результате бокового давления ледяных полей при сжатиях и подвижках ледяного покрова.
Точея : Беспорядочное морское волнение, возникающее при встрече волн различных размеров и форм, что приводит к сложению их, увеличению одних и уменьшению других.
Точка росы : Температура, до которой должен охладиться воздух, чтобы при неизменном атмосферном давлении и при данном содержании влаги находящийся в нем водяной пар достиг состояния насыщения и появилась роса.
Трансгрессия : Наступление моря на сушу при тектоническом опускании земной коры.
Трансформация воздушных масс : Постепенное изменение свойств передвигающейся воздушной массы под влиянием подстилающей поверхности (сильно прогретой, переохлажденной, сухой, водной, горной и другой).
Траппы : Излившиеся в разное время и наслоившиеся один на другой лавовые покровы базальтов, долеритов, диабазов, габбро при врезании в них рек и выветривании образуют ступенчатые склоны (плоскогорья Декан в Индии, Среднесибирское).
Трог, троговая долина : Горная долина, в которой движущийся ледник выпахал аллювиальные террасы, спрямил русло, выработал полого-вогнутое дно и крутые склоны к нему.
Тропические леса : Общее название лесов, распространенных в экваториальном, субэкваториальных и тропических поясах Земли.
Тропические пояса, тропики : Два природно-географических пояса, протягивающихся вдоль тропических параллелей между субэкваториальными и субтропическими поясами.
Тропосфера : Нижняя оболочка атмосферы, содержащая 80% воздуха и весь водяной пар.
Тугаи : Густые леса на поймах рек, пересекающих пустыни.
Туман : Скопление водяных капель или ледяных кристаллов, взвешенных в воздухе над земной поверхностью.
Тундролесье : Зональный тип ландшафтов, промежуточный между тундрами и тайгой и отличающийся от них по всем компонентам и ландшафтообразующим процессам.
Туннель, тоннель : Искусственное сооружение типа коридора под землей, горами или морями, для авто- и железнодорожного транспорта, а также для стока воды или прокладки коммуникаций.
Увал : Вытянутая невысокая возвышенность с мягкими очертаниями, сглаженной вершиной и подножиями, с пологими склонами.
Уклон реки : Отношение падения реки к ее длине.
Умеренные пояса : Два географических пояса Земли в северном и южном полушариях, имеющих резкие различия между собой.
Умеренный климat : Климат умеренных широт  с отличительной особенностью четкого деления года, на четыре сезона, хотя и неодинаковой продолжительности.
Ураган : Ветер разрушающей силы и продолжительности , когда скорости достигают 30 м/с и более.
Урез воды : Граница воды у берега водоема.
Урёма : Лиственный влаголюбивый лес на поймах и низких террасах, затопляемый в половодье.
Урман : Густой темнохвойный лес в таежной зоне с преобладанием пихты, ели, иногда с примесью сибирского кедра.
Устье : Место впадения реки в море, озеро или одной реки (притока) в другую, а также место, где воды реки из-за фильтрации, испарения, забора воды на орошение иссякают, уходя в почвогрунт.
Ущелье : Узкая глубокая и крутосклонная долина, расселина в горах, теснина, выработанная рекой в твердых породах или лёссах.
Фауна : Исторически сложившаяся совокупность видового состава (соболь, бурундук, дятел и так далее) всех животных какой-либо территории или акватории (фауна лесов, пустынь Кавказа, Аральского моря и тому подобное), а также определенного отрезка геологической истории, например фауна девонского периода.
Фён : Сухой и теплый ветер, нисходящий с гор в долины, часто сильный и порывистый.
Физиологическая сухость : Состояние почвы, когда при обилии влаги нуждающееся в ней растение не может ее использовать.
Физическое выветривание : Смотрите Выветривание.
Фильтрация : Движение, просачивание жидкостей или газов через пористую среду, например воды, нефти и газов в грунтах.
Фирн : Зернистый снег, точнее.
Фитонциды : Комплекс органических веществ, выделяемых высшими растениями.
Фитоценоз : Исторически сложившееся сообщество растений определенных видов в связи с одинаковыми климатическими условиями, однообразными горными породами и рельефом на почвах одного типа.
Флора : Исторически сложившаяся совокупность видов растений определенной территории (акватории), например флора Кавказа, а также определенного отрезка геологической истории, например флора каменноугольного периода.
Флювиогляциальные отложения : Косослоистые отложения песков, гравия, галечников в речках и ручьях, стекающих с тающих ледников.
Формация : Комплекс, естественное сочетание горных пород, совместное образование которых обусловлено общностью тектонических, физико-географических и особенно климатических условий образования.
Фотосинтез : Единственный на Земле процесс прямого превращения лучистой энергии Солнца (при воздействии на зеленую растительность, в том числе на микроскопические водоросли) в химические вещества, обеспечивающие возникновение и продолжение органической жизни.
Фригана : Разреженные растительные сообщества низкорослых нагорных, преимущественно вечнозеленых ксерофитных кустарников, полукустарников и кустарничков.
Фумарола : Выделения горячего вулканического газа в виде струй и спокойно парящих масс из трещин или каналов, расположенных на дне и в стенках кратера вулкана.
Фьорд, фиорд : Узкий глубокий морской залив с высокими крутыми и скалистыми берегами, далеко вдающийся в сушу.
Хамсин : Сухой, изнуряюще жаркий ветер южных направлений на северо-востоке Африки и в странах Ближнего Востока.
Хионосфера : Атмосферная оболочка толщиной до 10 км, в которой количество атмосферных осадков в твердом виде превышает жидкие.
Холм : Невысокая гора, горка с мягкими очертаниями, пологими склонами, округлой вершиной и нечетко выраженным подножием, обычно задернованная.
Холодная пустыня : Зональный ландшафт высоких широт  и высокогорий преимущественно в континентальных зонах умеренного географического пояса.
Холодный фронт : Передовая полоса активно продвигающейся холодной массы воздуха, вытесняющая вверх возникшую на месте массу теплого воздуха.
Хребет : Вытянутое в одну линию на много километров горное поднятие значительной высоты, имеющее хорошо выраженную водораздельную линию и относительно крутые два противоположных склона.
Целинные земли, целина : Земля, обладающая естественным плодородием, которая никогда не распахивалась, либо последние 70-100 лет.
Циклон : Область пониженного атмосферного давления, возникающая в теплой воздушной массе при столкновении ее с холодной, то есть при возникновении атмосферного фронта.
Цирк : Креслообразная вогнутая форма рельефа в горах.
Циркуляция : Ветры, воздушные течения преимущественно в тропосфере, важнейший климатообразующий процесс, происходящий от неоднородного атмосферного давления.
Цунами : Гигантские приливные волны большой длины на океанах и морях, обладающие огромной разрушительной силой для побережий.
Черная буря : Сильный сухой ветер, выдувающий пахотный слой почвы толщиной до 25 см (черная из-за темной окраски) и переносящий пылеватые частицы на значительные расстояния (смотрите Пыльная буря).
Черные земли : Остающиеся зимой без снега земли в результате частых оттепелей или сильных ветров, сметающих снег.
Чернь : Густые пихтово-еловые леса с примесью кедра (кедровой сосны) и осины на сухих местообитаниях южно-таежной подзоны Западной Сибири и склонов Алтая и Саянских гор.
Четвертичные отложения : Накопления очень разнообразных горных пород за последний период геологической истории Земли, покрывающих сплошным плащом всю ее поверхность с различной мощностью.
Чинк : Крутой, часто вертикальный обрыв плато высотой до 300-350 м в Западной Туркмении и Казахстане.
Шарьяж : Горизонтальный надвиг одной толщи геологических слоев на другую при боковых тектонических движениях в процессе развития геосинклинали.
Шельф : Прилегающая к берегу плоская или слабонаклонная подводная окраина материка общего с ним геологического строения.
Шибляк : Заросли низкорослых колючих ксерофитных кустарников и невысоких деревьев ; в отличие от маквиса преимущественно листопадных.
Широколиственный лес : Смотрите Леса широколиственные.
Широта географическая : Одна из географических координат, определяющих положение точек на поверхности Земли.
Шихан : Одиночный холм (сопка), хорошо выделяющийся в рельефе; останцовая возвышенность с правильными склонами и вершиной.
Шквал : Резкое кратковременное усиление ветра до скорости 30-40 м/с и более, сопровождающееся изменением его направления, грозой, ливнем.
Школьное лесничество : Трудовое объединение школьников старших и средних классов, работающих в лесу под руководством местного лесничества и учителей.
Шлейф предгорный : Рыхлые продукты разрушения гор и возвышенностей, снесенные со склонов и окаймляющие подножия, в виде слегка наклонной равнины.
Шотты : Сухие солончаковые или занятые в период дождей солеными озерами замкнутые бессточные впадины по северной окраине Сахары и в пределах Атласских гор в Африке.
Штриховка ледниковая , или борозды ледниковые, : Царапины длиной 2-5 см и глубиной в несколько миллиметров, образуемые вмерзшими в лед валунами при движении ледника по поверхности коренных пород ложа, а также на самих валунах.
Шуга : Рыхлые скопления кашеобразной массы льда, сала, мелкобитого льда, обломков заберегов или всплывшего на поверхность донного льда в переохлажденной воде.
Шхеры : Небольшие скалистые острова, во множестве встречающиеся у шхерного типа берегов морей и озер в Скандинавии, Финляндии, Шотландии (Великобритания) и Исландии.
Щебень : Рыхлая крупнообломочная горная порода из остроугольных неокатанных обломков размером 10-100 мм.
Щелочность почв : Повышенное содержание в почве щелочных солей, главным образом карбонатов натрия или магния.
Щелочные горные породы : Магматические породы со значительным содержанием щелочных минералов: пироксены, амфиболы и других, в состав которых входят натрий и калий.
Щит : Кристаллическая или метаморфическая часть фундамента платформы, поднятая тектоническими движениями на уровень или выше рыхлых отложений платформенного чехла и не покрытая ими.
Экваториальный пояс : Географический (природный) пояс, тянущийся вдоль экватора с некоторым смещением к югу (от 8° северной широты до 11° южной широты).
Экзарация : Ледниковая эрозия.
Экзогенные процессы : Процессы преобразования поверхностной части земной коры с ее рельефом под действием лучистой энергии Солнца, силы тяжести, воды и организмов.
Экзосфера : Самая высокая, конечная часть атмосферной оболочки.
Экологические условия : Разнообразные свойства и элементы географической среды с благоприятным или неблагоприятным влиянием на обитание и жизнедеятельность живого организма и сообществ (популяций) организмов.
Экологический кризис : Несоответствие быстрого развития технологической цивилизации и увеличения населения в геометрической прогрессии с медлительностью естественных процессов восстановления и воспроизводства природных условий и ресурсов.
Экосистема : Территория или акватория, на которой объединены друг с другом разнообразные сообщества живых организмов, связанные пищевыми связями и необходимыми для них общими условиями обитания.
Эксплуатация природных ресурсов : Основной фактор природопользования в целях социально-экономического развития человеческого общества.
Экспозиция склонов : Ориентация положительных и отрицательных форм рельефа (склоны гор, холмов, впадин, речных долин и тому подобного) по странам света, определяющая многие изменения в облике (структуре) и естественной производительности ландшафтов.
Экстраконтинентальный климат  наиболее
континентальный на земле, он отмечается в полосе,
близкой общему направлению тихоокеанского
побережья, на удалении от него на 300-200 км в
восточной сибири, забайкалье, восточной монголии
и на тибетском нагорье (долготная
экстраконтинентальная зона). это объясняется
положением на величайшем континенте евразии и
удалением от проникновения влажных морских масс воздуха. малая облачность (около
30% годовой) и сухой континентальный воздух
обусловливают быстрый прогрев поверхности почвогрунтов летом и днем и еще более
быстрое выстывание их зимой и ночью. летом даже
близ северного полярного круга температура
воздуха может достигать 38° и в те же сутки
понижаться ночью до 10°с. с конца октября до марта
здесь господствует азиатский антициклон,
почти без оттепелей царят морозы,
достигая -71°с в полюсе холода
северного полушария. атмосферных осадков мало : От 50 до 350 мм, хотя в горах в 2-2,5 раза больше.
Элювий, элювиальные отложения : Продукты выветривания горных пород, оставшиеся на месте своего образования.
Эндемизм : Распространение и приуроченность организмов к ограниченным районам и не встречающихся нигде больше.
Эндогенные процессы : Разнообразные движения земных слоев, их метаморфизация и проявления вулканизма.
Энергетический кризис : Нехватка источников энергии для бурно развивающейся промышленности, растущих бытовых потребностей людей.
Эоловые отложения : Вторичные отложения песков, реже лёссов, перемещаемые ветром в местах морских, эллювиальных, ледниковых (зандры), дельтовых и террасово-долинных (речных) накоплений.
Эпифиты : Растения, поселяющиеся на ветвях, стволах и листьях других растений.
Эрозия : Размыв и смыв горных пород.
Эрратический валун : Валун, перенесенный древним ледником на большое расстояние и состоящий из пород, отсутствующих в местах, где он оказался (например, граниты Скандинавии на Русской равнине).
Эстуарий : Воронкообразный, суживающийся к устью впадающей реки залив моря.
Эфемеры : Однолетние травы с коротким жизненным циклом (до 1,5 месяцев), завершающимся образованием семян (крупка весенняя, виды бурачка и другие).
Эффузивные горные породы : Напластования горных пород при излиянии расплавленных лав по тектоническим трещинам или по трубообразным каналам вулканов.
Ядро земли : Внутриземная геосфера с радиусом 3470 км.
Яр, крутояр : Крутые или отвесные высокие берега рек, подмываемые потоком, обрывы высоких террас, оврагов, озер, морей.
Яровые культуры : Сельскохозяйственные растения, дающие урожай в год посева.
Ярусность : Вертикальная зональность.
