Аббревиация : Сокращение онтогенеза в результате потери признаков или фаз развития, имевшихся у предков
Абиссальный : Организм, живущий на больших морских глубинах (3000
Абориген : Коренной обитатель какой-либо местности, страны
Абсцизовая кислота : Растительный гормон из группы липидов, который стимулирует образование отделительного слоя клеток у основания листового корешка, что приводит к опаданию листьев
Австралопитек : Ископаемая прямоходящая человекообразная обезьяна, передвигавшаяся на двух ногах
Автогенез : Концепция, согласно которой эволюционный процесс основан на внутренних потенциальных возможностях организмов и не зависит от внешних условий
Автолиз : Переваривание лизосомами содержимого собственной клетки
Автомиксис, аутомиксис : 1) самооплодотворение, слияние половых клеток, принадлежащих одной особи
Автополиплоидия : Кратное  или некратное (3n, 5n и т
Авторепродукция : Самовоспроизведение, одно из важнейших свойств живых клеток
Автостерильность : Неспособность пыльцы прорастать на рыльце пестика цветка того же растения
Автотомия, аутотомия : Защитная реакция организма животных, выражающаяся в самопроизвольном отбрасывании частей тела: конечностей (ракообразные), хвоста (ящерицы), щупальцев (полипы, актинии), внутренностей (голотурии) и др
Автотрофные организмы, автотрофы : Организмы, которые синтезируют компоненты своих клеток, используя в качестве единственного или главного источника углерода СО2
Агамия : Размножение без оплодотворения
Агамогония : Бесполое размножение, осуществляемое путем деления, почкования или др
Агглютинация : Реакция склеивания и оседания антигенных частиц (бактерий, эритроцитов, лейкоцитов и др
Агранулоциты : Незернистые лейкоциты, белые кровяные клетки, не содержащие в цитоплазме гранул
Агрессия : Форма поведения животных, направленная на защиту себя, потомства, партнера
Агробиоценоз, агроценоз : Совокупность организмов, обитающих на территории, занятой посевами или посадками культурных растений
Адаптация : 1) процесс приспособления организмов к определенным условиям внешней среды; 2) (во мн
Адаптивная радиация : Эволюционный процесс, приводящий к созданию множества различных форм живых существ, каждая из которых адаптирована к жизни в определенных условиях обитания
Адгезия : Способность преимущественно однотипных клеток образовывать агрегаты за счет слипания, а также приклеиваться своей поверхностью к субстрату
Аденин, 6-аминопурин : Пуриновое основание, которое наряду с гуанином, и пиримидиновыми основаниями &ndash; тимином и цитозином &ndash; входит в состав нуклеиновых кислот
Аденовирусы : ДНК-содержащие вирусы, поражающие различные органы позвоночных животных и человека
Аденозинтрифосфат : Основной энергетический ресурс живой клетки
Адреналин : Гормон надпочечников, медиатор нервной системы, имеющий метаболические эффекты
Азотофиксация : Один из важнейших процессов круговорота веществ в природе, который осуществляется азотофиксирующими бактериями , усваивающими азот воздуха и использующими его для синтеза различных азотосодержащих веществ
Акклиматизация : Приспособление организмов к новым условиям обитания, результатом которого является их успешное развитие и размножение
Аккомодация : В широком смысле термин означает приспособление органа или ткани к какому-либо воздействию
Акромегалия : Чрезмерный, непропорциональный рост конечностей и лицевых костей из-за нарушения функции гипофиза
Акросома : Органоид, расположенный на вершине головки сперматозоида
Акроцентрики : Неравноплечие хромосомы с одним длинным и вторым очень коротким плечом
Акселерация : Ускоренное половое созревание детей и подростков, сопровождающееся их более быстрым ростом и развитием
Аксон : Отросток нервной клетки (нейрона), по которому нервный импульс передается другим нервным клеткам или иннервируемым (эффекторным) органам
Актин : Белок, входящий в состав мышечных волокон животных
Активный транспорт веществ : Перенос веществ через мембрану против градиента концентрации  за счет энергии АТФ
Актиноморфизм : Развитие у растений цветка правильной формы, который имеет несколько плоскостей симметрии
Аллантоис : Одна из зародышевых оболочек высших позвоночных животных, присутствующая на ранних стадиях развития
Аллельные гены : Это гены, занимающие одинаковые локусы в гомологичных хромосомах и отвечающие за развитие альтернативных признаков
Альбинизм : Врожденное отсутствие пигментации, причиной которого являются мутации генов, отвечающих за синтез соответствующих пигментов
Альвеолы : 1) пузырьки на концах тончайших разветвлений бронхов, обвитые сетью капилляров, благодаря чему совершается газообмен между легкими и кровью; 2) ячейки в челюстях млекопитающих, в которых помещаются корни зубов
Альдостерон : Гормон надпочечников, регулирующий содержание минеральных веществ в крови
Аминокислоты : Органические кислоты, имеющие в своем составе одну или две аминогруппы  и карбоксильную группу (&ndash;СООН)
Амитоз : Прямое деление клетки путем перетяжки или инвагинации
Амнион : Одна из зародышевых оболочек высших позвоночных животных
Амплификация : 1)способность организма уравновешивать внешние воздействия
Амфимиксис : Половой процесс, при котором происходит слияние мужских и женских половых клеток (гамет)
Анаболизм : Одна из двух составляющих обмена веществ в организме, наряду с катаболизмом
Анаболия : Добавление в процессе эволюции новой стадии развития в конце морфогенеза какого-либо органа
Анагенез : Одно из кардинальных направлений эволюции, в основе которого лежит процесс постепенных изменений, приводящих к усложнению организации и совершенствованию существующих организмов
Анализаторы : Система нервных образований, воспринимающая и анализирующая импульсы раздражения, поступающие из внешней или внутренней среды
Анализирующее скрещивание : Одно из скрещиваний, входящих в систему гибридологического анализа; скрещивание гибрида с гомозиготной рецессивной формой
Анаэробы : Организмы, способные нормально жить и развиваться в бескислородной среде
Андрогенез : Развитие нового организма из яйцеклетки, ядро которой замещено ядром сперматозоида (у растений
Андроцей : Совокупность мужских генеративных органов (тычинок) в цветке
Анемофилия : Ветроопыление у растений
Анеуплоидия, гетероплоидия : Потеря клеткой одной или нескольких хромосом или, наоборот, присутствие лишних хромосом в наборе в результате неправильного расхождения или утраты хромосом в процессе деления материнской клетки
Анизогамия : Тип слияния половых клеток водорослей, при котором гаметы морфологически и физиологически отличаются друг от друга, и обе ( и  ) являются подвижными
Анималькулизм : Один из вариантов преформизма
Антеридий : Мужской генеративный орган споровых растений (водорослей, мхов, папоротников), а также грибов (оомицетов, аскомицетов)
Антиген : Чужеродные для данного организма вещества (белки, полисахариды и др
Антикодон : Последовательность из трех азотистых оснований в молекуле транспортной РНК , комплементарная соответствующему кодону в молекуле информационной РНК (иРНК)
Антиподы : Клетки, расположенные в нижнем (халазальном) конце зародышевого мешка покрытосеменных растений против яйцевого аппарата
Антитела : Глобулярные белки , синтезируемые клетками иммунной системы высших организмов, которые специфически связываются с чужеродными веществами (антигенами), индуцирующими их синтез
Антропогенез : Происхождение, становление и эволюция человека как вида
Апогаметия : Развитие зародыша покрытосеменных растений не из яйцеклетки, а из других клеток зародышевого мешка (синергид, антипод) в результате их оплодотворения или без него
Апомиксис : Размножение семенами без оплодотворения, которое возникло на базе полового процесса
Апоспория : Развитие нередуцированного зародышевого мешка покрытосеменных растений из соматической клетки семяпочки
Аппарат гольджи : Органоид эукариотической клетки, выполняющий секреторную функцию
Ароморфоз : Эволюционное изменение общего характера в строении и функциях организмов, приводящее к морфофизиологическому прогрессу
Архаллаксис : Изменение в развитии органа на самой ранней стадии морфогенеза, приводящее к перестройке всех последующих стадий его развития
Архегоний : Женский генеративный орган у мхов, папоротников, хвощей, плаунов, голосеменных
Атавизм : Появление у отдельных особей данного вида утраченных в процессе эволюции признаков
Ауксотрофы : Организмы (в основном микроорганизмы), утратившие способность к синтезу какого-либо метаболита (например, аминокислоты) из-за отсутствия нужного фермента
Аутбридинг : Скрещивание особей одного вида, не имеющих родственников в предыдущих 4
Аутосомы : Все хромосомы в клетке, кроме половых
Аутофагия : Процесс переваривания лизосомами содержимого собственной клетки
Ахроматиновое веретено : Структура митотически  делящейся клетки, формирующаяся на стадии метафазы из микротрубочек и имеющая форму веретена
Базальный : Относящийся к основанию, расположенный у основания или обращенный к нему (например, базальная мембрана, базальные ганглии и др
Базальное тельце : Структура, лежащая в основании ресничек и жгутиков эукариотических клеток, соединенная с системой микротрубочек
Бактериофаги : Бактериальные вирусы, имеющие в своем составе молекулу ДНК  и белки
Бактерии : Микроорганизмы с прокариотическим типом организации клеток
Банк генов : Культура бактериальных клеток , в которые посредством трансформации введены фрагменты чужеродной ДНК
Бацилла : Бактерии, имеющие палочковидную форму
Беккросс : Возвратное скрещивание гибрида с родительской формой
Белки : Важнейший химический компонент живой клетки; биополимеры, состоящие из последовательно соединенных пептидными связями  аминокислотных остатков
Бентос : Совокупность организмов, обитающих на дне водоемов (в грунте или на грунте)
Бивалент : Пара гомологичных хромосом, находящихся в состоянии конъюгации в процессе мейоза
Билатеральный : Двусторонняя симметрия у живых организмов, при которой тело делится плоскостью симметрии на две одинаковые боковые половины
Биоакустика : Раздел зоологии, изучающий звуковую сигнализацию, ориентацию в пространстве и коммуникацию животных
Биогенетический закон : Сформулированный в 1866 г
Биогенные вещества : Химические соединения, производные обмена веществ живых организмов
Биогенез : В широком смысле биогенез
Биогеоценоз : Единый природный комплекс, включающий объединенные общим обменом веществ и энергии живые существа и окружающую их абиотическую среду
Биодеграданты : Микроорганизмы, способные к утилизации сложных химических соединений
Биоиндикатор : Организм, присутствие или поведение которого служит показателем состояния окружающей среды (например, обилие раков в водоеме является свидетельством его чистоты)
Биокатализ : Обменный процесс в живой клетке, протекающий с участием биокатализаторов или ферментов
Биомасса : Суммарная масса живых организмов , выражаемая в единицах сухого или сырого веса по отношению к единице площади (г/м2, кг/м3)
Биометрия : Раздел вариационной статистики, основанный на использовании в биологии математических методов
Биомы : Ландшафтно-географические комплексы на поверхности земли, характеризующиеся определенными климатическими условиями и определенным составом живых организмов
Бионика : Научное направление, возникшее на стыке биологии и кибернетики, которое изучает и использует особенности функционирования живых организмов при построении сложных технических систем (например, принцип генетического кодирования, механизмы макроэнергетических процессов и др
Биополимеры : Высокомолекулярные химические компоненты живой клетки, состоящие из повторяющихся элементов
Биоритмы : Периодически повторяющиеся изменения интенсивности и характера биологических процессов, помогающие животным ориентироваться во времени (биологические часы) и приспосабливаться к изменениям окружающей среды
Биосинтез : 1) процесс образования в клетке органических веществ из более простых химических соединений
Биосфера : &laquo;живая&raquo; оболочка Земли, область существования живых организмов, охватывающая часть атмосферы, часть литосферы и всю гидросферу
Биота : Сложившаяся совокупность живых организмов, объединенных общей территорией, вне зависимости от наличия или отсутствия экологических связей между ними
Биотехнология : 1) в традиционном понимании
Биотип : Мелкая таксономическая категория; группа особей в составе популяций, имеющих сходные генотипические и фенотипические признаки
Биотоп : Участок суши или водоема с относительно однотипным комплексом абиотических факторов, занятый одним биоценозом
Биоценоз : Сообщество живых организмов (растений, животных, грибов, микроорганизмов), заселяющих определенную территорию (биотоп)
Бластодерма : Поверхностный слой клеток бластулы, окружающий бластоцель (при полном дроблении) или желток (при поверхностном дроблении)
Бластомеры : Клетки, образующиеся в результате дробления яйца
Бластопор : Отверстие на вегетативном полюсе зародыша, посредством которого на стадии гаструлы он сообщается с внешней средой
Бластоцель : Полость внутри зародыша на стадии бластулы (первичная полость)
Бластоциста : Одна из стадий эмбриогенеза млекопитающих (следующая за морулой)
Бластула : Стадия дробления зиготы с образованием многоклеточного недифференцированного зародыша
Бриология : Раздел ботаники, изучающий мхи
Брахидактилия : Короткопалость; наследственный дефект, обусловленный доминантной мутацией, вызывающей срастание концевых фаланг
Бутон : Цветочная почка, нераспустившийся цветок
Вакуоль : Полость в цитоплазме клеток, ограниченная однослойной мембраной и содержащая клеточный сок
Вакцина : Препарат из живых (ослабленных, обезвреженных) или мертвых микроорганизмов, используемый для иммунизации человека и животных с профилактической или лечебной целью
Вегетативное размножение : Образование новой особи из какой-либо части тела растения или животного
Векторы : Молекулы ДНК, которые используются в опытах по генной инженерии для переноса в клетку чужеродных генов
Венчик : Часть двойного околоцветника цветка покрытосеменных растений, состоящая из свободных или сросшихся лепестков
Вены : Кровеносные сосуды, идущие от органов и тканей к сердцу
Вид : Основная таксономическая категория; совокупность особей , объединенных общим происхождением, общим ареалом и способных скрещиваться друг с другом с образованием плодовитого потомства
Видообразование : Процесс возникновения новых видов, основным механизмом которого является репродуктивная изоляция внутривидовых групп особей
Вирусы : Неклеточные частицы с упорядоченной организацией, содержащие генетический материал (ДНК или РНК), упакованный в белковую оболочку, или капсид
Витальный : Жизненный, прижизненный, имеющий отношение к жизненным явлениям
Витамины : Биологически-активные низкомолекулярные органические соединения, необходимые для нормального развития живых организмов
Включения : Непостоянно присутствующие в клетке образования, к которым относятся: секреторные гранулы, скопления запасных питательных веществ или продуктов обмена, пигментные скопления
Возбудимость : Одно из важнейших свойств живых организмов, их способность реагировать на действие раздражителей путем повышения физиологической активности
Возбуждение : Ответная реакция организма на действие раздражителя, сопровождающаяся изменением обмена веществ в рецепторных клетках, переходом их из состояния относительного физиологического покоя к высокой активности
Галофиты : Растения, которые растут на засоленных почвах (солончаках, солонцах)
Гаметы : Женские и мужские половые клетки (яйцеклетки и сперматозоиды, или спермии), принимающие участие в процессе оплодотворения
Гаметофит : Одна из двух фаз развития растительного организма (половое поколение), которая чередуется со спорофитом
Гаплоид : Организм, имеющий в клетках гаметический (одинарный) набор хромосом
Гаструляция : Период зародышевого развития многоклеточных животных, который следует за дроблением (стадия бластулы)
Гейтеногамия : Разновидность самоопыления у раздельнополых однодомных растений, при которой женские цветки опыляются пыльцой мужских цветков той же особи
Гемоглобин : Красный пигмент крови человека, позвоночных и некоторых беспозвоночных животных
Гемоглобинопатии : Болезни, возникающие из-за наследственного нарушения функции гемоглобина
Гемопоэз : Кроветворение, процесс образования, развития и созревания форменных элементов крови (эритроцитов, лейкоцитов и тромбоцитов) из тотипотентных стволовых клеток
Гемофилия : Наследственное заболевание, сопровождающееся сильной кровоточивостью
Ген : Основная единица наследственной информации; фрагмент молекулы ДНК, в котором закодирована информация о структуре специфического белка (в некоторых случаях
Генетический код : Запись информации о первичной структуре белка в виде определенной последовательности пуриновых и пиримидиновых оснований в молекуле ДНК
Генная инженерия : Направление в генетических исследованиях, целью которого является создание клеток и организмов с заранее запланированными свойствами посредством введения в геном чужеродной информации
Геном : Совокупность генов в гаплоидном наборе хромосом данного вида организмов
Генотерапия : Современный метод лечения болезней, вызванных изменениями в структуре генов, основанный либо на введении нормальной копии поврежденного гена, либо на регулировании его экспрессии
Генотип : Совокупность всех генов, имеющихся в наборе хромосом клетки или организма
Генофонд : Совокупность генов данной популяции или вида
Геотропизм : Направленные ростовые движения растений, вызванные силой земного притяжения
Гермафродитизм : Обоеполость; одновременное функционирование в организме мужских и женских половых органов
Гетерогония : Одна из форм чередования поколений
Гетеродуплекс : Участки спаривания двух одиночных цепей ДНК, принадлежащих разным молекулам (гибридная ДНК)
Гетерозиготный : Генотип, в котором представлены два разных аллельных гена: доминантный и рецессивный
Гетерозис : Гибридная сила, явление более мощного развития гибридов I поколения по сравнению с родительскими формами
Гетерокотилия : Явление образования двух разных семядолей в зародыше семенных растений
Гетеростилия : Разностолбчатость; развитие цветков, различающихся по длине столбиков и тычиночных нитей, благодаря чему рыльца и пыльники располагаются на разной высоте
Гетерохроматин : Интенсивно окрашивающиеся, неактивные участки хромосомы, находящиеся в состоянии плотной спирализации
Гиббереллины : Эндогенные регуляторы роста из разряда дитерпеноидных кислот, которые в малых концентрациях встречаются у многих высших растений
Гибрид : Организм, развившийся из зиготы, образованной в результате слияния двух генетически разнородных гамет, принадлежащих разным родителям
Гибридома : Клетка, образующаяся в результате слияния раковой клетки с клеткой, вырабатывающей антитела
Гибридизация : Скрещивание двух генетически разнородных особей , при котором один партнер выступает в качестве материнского родителя, а другой
Гинандроморфизм : Образование половых мозаиков
Гиногенез : Развитие зародыша, при котором мужская гамета (спермий, сперматозоид) проникает в яйцеклетку, активирует ее к морфогенезу, но в дальнейшем развитии не участвует и дегенерирует
Гинодиэция : Явление полового диморфизма у растений, наличие в популяции двух половых типов растений: с обоеполыми цветками и с женскими цветками
Гистоны : Простые белки, с основными свойствами, в комплексе с ДНК и другими белками входящие в состав эукариотических хромосом
Гликолиз : Анаэробный процесс ферментативного расщепления углеводов
Гликопротеиды : Сложные белки, в составе молекул которых содержатся углеводные компоненты
Гомеостаз : Присущая биологическим системам разного уровня организации (организмам, популяциям, видам и т
Гомологичные ряды в наследственной изменчивости : Параллелизм в проявлении мутационной изменчивости у родственных видов и родов, возведенный Н
Гомункулус : Человекоподобное существо, которое, согласно взглядам естествоиспытателей XVII в
Гонады : Половые железы животных, в которых образуются половые клетки и вырабатываются половые гормоны
Гормоны : Биологически активные вещества, вырабатываемые железами внутренней секреции или скоплениями специализированных клеток, выполняющие функцию регуляторов деятельности других клеток и органов
Гранулоциты  &ndash; форменные элементы крови, вместе с лимфоцитами относятся к группе лейкоцитов : Белых кровяных телец, при этом составляют 60&ndash;70% от их содержания
Группы крови : Групповая дифференциация крови на основе иммунологических свойств, обусловленных присутствием специфических антигенов
Гуморальная регуляция : Один из механизмов регуляции процессов жизнедеятельности, который осуществляется биологически активными веществами, в первую очередь гормонами, содержащимися в крови, лимфе и тканевой жидкости
Гумус : Высокомолекулярное органическое вещество, образующееся в результате разложения растительных и животных остатков и продуктов жизнедеятельности
Дальтонизм : Наследственная аномалия , обусловленная рецессивной мутацией гена (d), локализованного в Х-хромосоме
Движение : Перемещение организма, его отдельных частей и клеток посредством активного изменения формы или месторасположения
Двойное оплодотворение : Тип полового процесса, характерный для покрытосеменных растений, который слагается из двух актов: оплодотворения яйцеклетки  и оплодотворения центральной клетки зародышевого мешка, содержащей два (или более) полярных ядра (тройное слияние) с последующим развитием из нее эндосперма
Двудольность : Присутствие в зародыше покрытосеменных растений двух семядолей, в норме имеющих одинаковый размер, форму и окраску
Девиация : Одна из форм филэмбриогенеза; уклонение в развитии органа на средних стадиях развития зародыша, вызванное мутацией
Дегенерация : 1) постепенное отмирание клеток или тканей в процессе онтогенеза организма, обычно обусловленное прекращением их функции
Дезоксирибоза : Пятиуглеродный моносахарид, входящий в состав ДНК
Дезоксирибонуклеазы : Ферменты, осуществляющие деградацию молекулы ДНК путем катализа реакции расщепления фосфодиэфирных связей
Дезоксирибонуклеиновая кислота : Макромолекулярный биополимер, состоящий из двух полинуклеотидных цепей, закрученных в форме двойной, спирали
Делеция : Один из типов хромосомных мутаций (хромосомных перестроек), в основе которого лежит потеря участка хромосомы
Дем : Кратковременно существующая внутривидовая группировка, отличающаяся высокой степенью панмиксии
Дендрит : Короткий ветвящийся цитоплазматический отросток нейрона, не имеющий миелиновой оболочки
Дендрология : Раздел ботаники, изучающий древесные и кустарниковые растения
Дерма : Нижний, находящийся под эпидермисом слой кожи у позвоночных животных, состоящий из клеток соединительной ткани
Десмосома : Специализированная структура контактирующих поверхностей соседних клеток
Детерминация : Генетически запрограммированное направление дифференциации клеток
Детерминант : 1) согласно взглядам А
Диакинез : Завершающая стадия I деления (редукционного) мейоза
Диапауза : Временный период покоя в развитии, свойственныйпредставителям различных классов животных
Диаспора : Часть растения различной природы (клубень, луковица, выводковая почка), естественно отделяющаяся от материнской особи и служащая для размножения и расселения
Диастола : Фаза в цикле работы сердца, во время которой происходит расслабление сердечных мышц и расширение его полостей
Диафрагма : Мышечная перегородка, отделяющая у млекопитающих грудную полость от брюшной
Дивергенция : Эволюционный процесс расхождения популяций, приводящий к возникновению новых систематических групп (разновидностей, подвидов, видов)
Дикарион : Двухъядерная клетка у некоторых грибов (например, аскомицетов), содержащая гаплоидные женское и мужское ядра
Диктиосома : Структурная единица комплекса Гольджи, представляющая собой систему плоских мембранных мешочков (цисцерн), расположенных стопкой по 5
Диминуция хроматина : Частичная потеря хромосомного материала, наблюдающаяся при распаде хромосом на мелкие фрагменты во время клеточного деления
Диморфизм : Наличие в составе одной систематической группы (популяции, вида) двух хорошо отличимых по какому-либо признаку форм
Диплоид : Организм, набор хромосом которого состоит из пар гомологичных хромосом
Диссеминация : Процесс распространения диаспор
Диссимиляция : Одна из двух составляющих процесса метаболизма, наряду с ассимиляцией
Дистальная : Отдаленная от центра часть тела
Дифференциация : 1) клеточная дифференциация (дифференцировка)
Дихогамия : Явление неодновременного созревания женских и мужских органов в цветке покрытосеменных растений
Доместикация : Одомашнивание диких животных и растений путем создания благоприятных условий существования
Доминант : Вид, численно преобладающий в биоценозе
Донор : Организм, чьи клетки, ткани, органы или их части переносятся в другой организм
Дорсальный : Орган или часть тела, относящиеся к спинной стороне
Дорсовентральный : Направленный от спинной поверхности тела к брюшной
Дрейф генов : Один из факторов генетической динамики популяции, чье действие приводит к изменению ее генотипической структуры
Дробление : Ряд последовательных митотических делений зиготы , в результате которых формируется бластула, состоящая из отдельных клеток &ndash; бластомеров
Дупликация : Один из типов хромосомных мутаций, при котором происходит удвоение участка хромосомы
Дыхание : Одна из основных жизненных функций организмов, с помощью которой осуществляется газообмен
Евгеника : Учение о совершенствовании биологической природы человека с помощью генетических методов
Естественный отбор : Основной движущий фактор эволюции живых организмов с точки зрения теории Ч
Железы : Органы животных и человека, выделяющие специфические биологически активные вещества (секрет), участвующие в различных физиологических процессах организма
Желёзки : Органы выделения у растений
Живорождение : Способ воспроизводства потомства у животных, когда зародыш развивается из яйца в организме матери, питаясь через плаценту, и появляется на свет без яйцевых оболочек в более или менее сформированном виде
Жизнь : Процесс сохранения и воспроизведения существующих биологических форм при условии их активного взаимодействия с окружающей средой
Завязь : Расширенная нижняя часть пестика, в которой развивается одна, несколько или большое количество семязачатков
Затравка : Короткий фрагмент РНК, необходимый для инициации синтеза дочерней цепи ДНК, комплементарно соединяющийся с материнской цепочкой
Заказник : Охраняемая территория, в пределах которой запрещаются отдельные формы хозяйственной деятельности в целях сохранения различных природных ресурсов
Законы менделя : Закономерности наследования признаков, открытые чешским ученым Г
Заповедник : Особо охраняемая территория, на которой полностью исключена хозяйственная деятельность в целях сохранения в нетронутом виде природных комплексов
Зародыш : Начальные этапы развития животного организма от яйца до выхода его из зародышевых оболочек или рождения
Заросток : Половое поколение  у папоротников, хвощей, плаунов, селагинелл
Зеленая революция : Резкое повышение урожайности сельскохозяйственных культур, наблюдавшееся в 60-х гг
Зерновка : Твердый плод злаковых растений , с тонким околоплодником, плотно прижатым к семени
Зигоморфизм : Развитие цветка неправильной формы, имеющего одну плоскость симметрии
Зигота : Оплодотворенная яйцеклетка: диплоидная или полиплоидная клетка, образующаяся в результате слияния женской и мужской гамет
Зообентос : Животные, обитающие на дне и в грунте морских и пресных водоемов
Зоопланктон : Совокупность животных, населяющих толщу морских и пресных вод и пассивно перемещающихся вместе с течением
Зооспора : Снабженная жгутиками подвижная клетка водорослей и некоторых грибов, которая служит для бесполого размножения
Идиоадаптация : Эволюционный процесс, приводящий к повышению частной приспособленности организмов к условиям обитания и существенно не отражающийся на общем уровне организации (в отличие от ароморфоза)
Идиограмма, кариограмма : Систематизированное изображение полного набора хромосом (кариотипа) в виде рисунка или микрофотографии
Идиоплазма : Гипотетическое вещество, носитель наследственности
Изогамия : Процесс слияния гамет, характерный для низших организмов (одноклеточных водорослей, низших грибов, простейших)
Изоляция : Один из факторов генетической динамики популяции, приводящий к изменению ее генотипической структуры
Изомеразы : Ферменты, катализирующие взаимопревращения изомеров
Изоферменты : Разные формы одного и того же фермента со сходной каталитической активностью, различающиеся по своим физико-химическим и иммунологическим свойствам
Изохромосомы : Хромосомы с двумя абсолютно одинаковыми плечами
Имагинальный диск : Презумптивный  зачаток будущего органа в личинках и куколках насекомых и некоторых других групп беспозвоночных животных
Имаго : Взрослая стадия развития насекомых и некоторых других членистоногих, на которой особи достигают полного развития, в том числе полового
Иммиграция : 1) вселение организмов в новое местообитание
Иммунизация : Создание искусственного иммунитета путем введения в организм вакцины
Иммунитет : Невосприимчивость организма к действию факторов, которые могут нарушить его гомеостаз, в частности к возбудителям инфекционных заболеваний
Иммуногенетика : Раздел генетики, изучающий генетические механизмы иммунитета и тканевой несовместимости
Иммуноглобулины : Антитела: сложные белки из класса гликопротеидов, участвующие в реакции обезвреживания чужеродных для организма веществ
Имплантация : Внутрь и plantatio
Импринтинг : 1) запечатление в памяти животного признаков какого-либо объекта; например фиксация в памяти новорожденных птенцов образа матери; 2) геномный импринтинг
Инбридинг : Близкородственное разведение; скрещивание особей, находящихся в высокой степени родства и, следовательно, обладающих сходными генотипами
Инверсия : Один из типов хромосомных мутаций, поворот участка хромосомы на 180&deg;
Инволюция : Упрощение строения и функций органов в процессе эволюции, а также их атрофия при патологии и старении
Ингибиторы : Общее название для различных веществ, подавляющих активность ферментативных систем живых клеток (ингибиторы дыхания, роста, деления клетки, синтеза ДНК и др
Индикаторы биологические : Растения и животные или их сообщества, присутствие и состояние которых отражает общее состояние или степень загрязнения окружающей среды
Индукция : 1) форма межклеточных взаимодействий, при которой вырабатываемое клетками вещество-индуктор оказывает влияние на процесс развития других клеток
Инсайт : Внезапное, не связанное с обучением проявление животными элементов разумной деятельности
Инсектициды : Вещества, которые используются в сельском хозяйстве или быту для уничтожения вредных насекомых
Инстинкт : Генетически детерминированная адаптивная форма поведения, свойственная животным в определенных условиях
Интегумент : Покров семяпочки высших растений, окружающий и защищающий ее центральную часть
Интеркалярный рост : Рост растений в длину за счет деления клеток ниже конуса роста, вставочный рост
Интеркинез : Период времени между I и II делениями мейоза, обычно непродолжительный, с частичной деконденсацией хромосом
Интерфаза : Функционально активная и значительно более продолжительная по сравнению с последующим митозом часть клеточного цикла
Интерференция : 1) явление подавления одного кроссинговера другим, идущим в соседнем районе хромосомы
Интерфероны : Видоспецифичные белки, образующиеся в клетках животных и человека и обладающие иммунными свойствами
Интина : Внутренняя оболочка пыльцевого зерна, представляющая собой тонкую полупроницаемую мембрану
Интроны : Вставки; участки в составе некоторых генов, не несущие смысловой нагрузки и чередующиеся сэкзонами
Информосомы : Частицы, состоящие из иРНК и белка, в которых генетическая информация хранится до начала процесса трансляции
Инцухт : Принудительное самоопыление перекрестноопыляющихся растений
Искусственный  отбор : Отбор в популяциях культурных растений и животных
Кадастр : Систематизированная опись биологических объектов, содержащая их характеристику, классификацию, данные о динамике, социально-экономическую оценку
Кайнозой : Новая эра в истории Земли, которая последовала за мезозоем и продолжается в настоящее время
Каллоза : Сложный полисахарид, состоящий из &beta;-1,3-глюканов, который откладывается во время мейоза в оболочке микроспороцитов покрытосеменных растений между плазмолеммой и первичной целлюлозной стенкой
Каллус : Раневая ткань растений, образующаяся в местах разрезов и разрывов и способствующая заживлению
Камбий : Слой клеток между древесиной и лубом в стеблях и корнях растений
Камедь : Выступающий на коре деревьев при повреждении густой, быстро затвердевающий сок
Каннибализм : Внутривидовое хищничество у животных, которое чаще всего наблюдается в неблагоприятных условиях обитания при дефиците пищевых ресурсов
Канцерогенез : Процесс образования и развития злокачественной опухоли
Канцерогены : Вещества, вызывающие развитие злокачественных опухолей
Капилляры : Тончайшие сосуды, которые замыкают кровеносную систему, соединяя между собой артерии и вены
Капсид : Белковая оболочка, в которую заключен геном вируса (молекула ДНК или РНК)
Кариогамия : Слияние ядер женских и мужских половых клеток (гамет) в процессе оплодотворения с образованием ядра зиготы
Кариокинез : Деление клеточного ядра
Кариолимфа, кариоплазма : Содержимое ядра без хроматиновых структур
Кариология : Раздел биологии, изучающий структуру и функции клеточного ядра, а также исследующий кариотипы
Кариосистематика : Область биологии, находящаяся на стыке систематики, цитологии и генетики
Кариотека : Оболочка вокруг ядра эукариотической клетки, состоящая из двух мембран (внешней и внутренней), между которыми находится перинуклеарное пространство
Кариотип : Набор хромосом, специфичный для каждого вида животных и растений
Каротины : Оранжево-желтые пигменты из группы каратиноидов, изомеры, содержащие ненасыщенный углерод (С40Н56)
Кастрация : Удаление из организма половых желез
Катаболизм : Одна из составляющих обмена веществ в живых клетках, наряду с анаболизмом
Катагенез : Направление эволюционного развития, при котором наблюдается снижение уровня организации живых систем (регрессивная эволюция)
Каталаза : Фермент, хромопротеид, катализирующий реакцию разложения перекиси водорода на Н2О и О2
Катализатор : Вещество, увеличивающее скорость химических реакций
Каудальный : Расположенный ближе к заднему концу тела, к хвосту
Кейлоны : Вещества из разряда низкомолекулярных гликопротеидов, регулирующие процесс клеточной пролиферации
Кинетохор : Специализированная структура делящейся клетки, формирующаяся чаще всего в районе центромеры
Кислородный эффект : Увеличение процента выхода мутаций при помещении облученных клеток в кислородную среду
Кладогенез : Одно из направлений эволюции, приводящее к увеличению разнообразия существующих видов
Клейстогамия : Форма самоопыления и самооплодотворения в нераскрывающихся цветках
Клетка : Основная структурная, генетическая и функциональная единица всех живых существ
Клеточная теория : Учение о происхождении и развитии клеток, основные положения которого в первой половине ХIХ в
Клеточный цикл, жизненный цикл клетки : Время существования клетки от начала одного деления до начала другого или смерти
Клон : Генетически однородное потомство, возникающее при бесполом или вегетативном размножении
Колеориза : Плёнчатое образование, окружающее кончик корня злаков и цикадовых, называемое корневым влагалищем
Колинеарность : Соответствие между первичной структурой ДНК  и первичной структурой кодируемого ею белка
Колициногенность : Способность бактериальных клеток продуцировать колицины
Коллаген : Высокомолекулярный фибриллярный белок, входящий в состав клеток соединительной ткани
Колонии : 1) форма объединения живых организмов, размножающихся бесполым путем ременно скученный образ жизни (бактерии, пчелы, муравьи, птицы и др
Комменсализм : Форма симбиоза; временное или постоянное сожительство особей разных видов, при котором один из партнеров (комменсал) односторонне извлекает пользу из другого (хозяина) в аспекте взаимоотношений с внешней средой
Компетентность : 1) особое физиологическое состояние клетки, когда она способна воспринимать чужеродную ДНК (трансформация)
Комплементарность : 1) пространственная взаимодополняемость молекул, приводящая к образованию вторичной и третичной структуры макромолекул
Комплементация межаллельная : Восстановление дикого фенотипа при переходе двух мутаций в одном гене из транс-положения  в цис-положение (водной нити ДНК или одной хромосоме)
Конвергенция : Появление в процессе эволюции одинаковых признаков у разных групп организмов
Конверсия : 1) фаговая конверсия
Конгруэнция : Соответствие в строении и поведении особей, возникающее в ходе внутривидовых взаимоотношений
Конидии : Споры грибов, образующиеся на мицелии или на специализированных структурах
Конкуренция : Форма внутривидовых и межвидовых отношений, имеющая вид борьбы за существование
Консорция : Структурная единица биоценоза, которая объединяет организмы, связанные между собой топическими (пространственными) или трофическими (пищевыми) связями
Конститутивные мутанты : Формы микроорганизмов с непрерывной экспрессией какого-либо гена вследствие мутаций, нарушающих систему регуляции
Консумент : Гетеротрофный организм, использующий для питания готовое органическое вещество, вырабатываемое хемосинтезирующими и фотосинтезирующими организмами (продуцентами)
Конус роста : Зона роста на конце каждого нарастающего органа растения, состоящая из меристематических клеток и их производных
Конъюгация : 1) половой процесс у бактерий, который контролируется специфической плазмидой, так называемым фактором фертильности (F-фактор)
Копуляция : 1) половой акт у животных, как имеющих, так и не имеющих копулятивные органы; 2) процесс соединения двух половых клеток, внешне не отличающихся друг от друга (водоросли, низшие грибы)
Корневище : Подземный побег у многолетних трав и кустарников, который служит местом отложения запасных питательных веществ и является органом вегетативного размножения
Корневой чехлик : Защитное образование на растущей верхушке корня в виде многослойного конусовидного колпачка, состоящего из меристематических клеток с ослизняющимися оболочками
Корнеплод : Утолщение корня у растений, которое служит местом отложения запасных питательных веществ
Корреляция : Взаимосвязь в развитии различных признаков организма
Кортикостероиды : Гормоны надпочечников позвоночных, регулирующие важные направления метаболизма
Космополиты : Виды, обитающие в разных (иногда во всех) районах земного шара
Кофактор : Соединение небелковой природы, необходимое для активации фермента
Креационизм : Философская концепция конца XVIII
Криобиология : Раздел биологии, изучающий влияние низких и сверхнизких температур на живые организмы
Криофилы : Организмы, живущие в условиях низких температур
Криптогамные растения : Тайнобрачные растения с очень мелкими, незаметными глазу органами оплодотворения, не имеющие цветков (папоротники, хвощи, мхи, водоросли)
Криптомерия : Один из типов взаимодействия неаллельных генов, при котором присутствие одного из двух взаимодействующих генов в рецессивной форме (аа) не дает возможность проявляться доминантному аллелю другого гена (В_)
Кроманьонцы : Первые современные люди, ископаемые остатки которых впервые найдены в местечке Кро-Маньон на юге Франции
Кроссбридинг : Одна из форм аутбридинга
Кроссинговер : Процесс обмена гомологичных хромосом участками во время их конъюгации в профазе I мейоза
Ксантофиллы : Желтые пигменты из группы каротиноидов, которые содержатся в почках, листьях, цветках и плодах цветковых растений, а также в клетках водорослей и микроорганизмов
Ксении : Проявление признаков отцовского родителя в эндосперме, развивающемся на материнском растении
Ксенобиотики : Чужеродные для живых организмов химические соединения, которые нарушают природную среду и вредят здоровью человека
Ксерофиты : Растения, обитающие в засушливых районах: степях, полупустынях, пустынях, на склонах гор
Ксилема : Проводящая ткань сосудистых растений, которая служит для проведения воды и растворенных в ней минеральных веществ от корней к другим органам растения
Культура in vitro : Выращивание на искусственных питательных средах клеток, тканей и органов растений и животных
Кумуляция : Накопление, увеличение концентрации какого-либо вещества в организме, которое часто имеет вредный эффект
Лабильность : Функциональная подвижность, неустойчивое состояние молекул, клеток, организмов
Лактоза : Молочный сахар, дисахарид, вырабатываемый клетками молочной железы и в свободном виде присутствующий в молоке всех млекопитающих
Лактозный оперон : Группа генов в хромосоме E
Ламаркизм : Эволюционная концепция, разработанная французским ученым Ж
Ламеллы : Мембранные выросты, отходящие от плоских мембранных дисков  и соединяющие между собой отдельные граны в хлоропластах
Латентный : Период времени от момента какого-либо воздействия на организм до появления видимой ответной реакции
Латеральный : Расположенный сбоку от оси тела
Лейкопласты : Бесцветные пластиды в растительных клетках, места синтеза различных запасных питательных веществ: крахмала (амилопласты), масел (элайлопласты), белков (протеопласты)
Лейкоциты : Бесцветные клетки крови животных и человека, принимающие активное участие в воспалительных реакциях организма
Лептотена, лептонема : Стадия ранней профазы I деления мейоза (редукционного)
Летальный : Имеющий смертельный исход (например, летальная мутация, летальная доза радиации и др
Летальные гены : Гены, вызывающие гибель их носителей
Лигазы : Класс ферментов, осуществляющих &laquo;сшивание&raquo; различных молекул или их фрагментов друг с другом при использовании энергии АТФ
Лигнин : Биополимер, который наряду с целлюлозой и др
Лизин : Одна из незаменимых аминокислот, входящая в состав почти всех белков про- и эукариот
Лизис : Разрушение и растворение клеток под действием ферментов лизосом или других агентов, обладающих литическим действием
Лизогения : Один из вариантов взаимодействия бактериальной клетки и вирулентного фага, когда после встраивания в геном клетки-хозяина фаг существует в латентной (неактивной) форме профага
Лизосома : Органоид в клетках животных и грибов, представляющий собой пузырек, ограниченный однослойной мембраной и содержащий набор из более чем 20-ти гидролитических ферментов (активный сок)
Лимфа : Бесцветная жидкость, производная крови, близкая ей по составу, циркулирующая в лимфатической системе и межклетниках позвоночных животных и человека
Лимфоцит : Основной структурный элемент лимфы, относящийся к разряду агранулярных лейкоцитов
Линкер : 1) синтетический короткий двуцепочечный фрагмент ДНК ных молекул; 2) участок ДНК между двумя нуклеосомами
Линька : Периодическая смена внешних покровов у животных
Липкие концы : Комплементарные одноцепочечные участки ДНК, выступающие с обоих концов двуцепочечной молекулы при действии ферментов рестрикции
Липиды : Жироподобные вещества, производные жирных кислот, спиртов или альдегидов, входящие в состав живых клеток
Лист : Вегетативный орган высших растений, выполняющий ряд важнейших жизненных функций
Лихенология : Раздел ботаники, изучающий лишайники
Личинка : Вторая стадия  метаморфоза у многоклеточных беспозвоночных и некоторых позвоночных животных
Лишайники : Симбиотические организмы, состоящие из гриба и водоросли, которые находятся в паразитических отношениях друг с другом
Лодикула : Пленка в цветке злаков (обычно их 2
Локус : Место расположения гена в хромосоме
Луб : Проводящая ткань, вторичная флоэма древесных растений
Луковица : Видоизмененный подземный  побег, имеющий короткий плоский стебель и мясистые, плотно сложенные листья
Макронуклеус : Вегетативное ядро инфузорий, регулирующее все важнейшие жизненные процессы (кроме деления)
Макрофаги : Крупные клетки изменчивой формы, имеющиеся в составе крови, соединительной ткани, печени и др
Макроэволюция : Эволюционные преобразования, приводящие к появлению новых крупных систематических таксонов
Макроэргические соединения : Химические компоненты живых систем, содержащие богатые энергией связи
Малые ядерные рнк, мя-рнк : Короткие цепочки из нескольких сотен рибонуклеотидов , взаимодействующие по принципу комплементарности на границе интрон&ndash;экзон во время сплайсинга и препятствующие исходному воссоединению фрагментов
Матрикс : 1) гиалоплазма; основа цитоплазмы живых клеток, представляющая собой сложную коллоидную систему, которая объединяет все внутриклеточные структуры и является местом осуществления многих процессов метаболизма (гликолиз, синтез жирных кислот, нуклеотидов и др
Матричный синтез : Способ воспроизводства молекул ДНК и синтеза молекул РНК, при котором одна нить ДНК служит матрицей (образцом) для построения дочерней молекулы
Мегаспора, макроспора : 1) у разноспоровых папоротников и плаунов
Мегаспорангий , макроспорангий : Орган споровых и семенных растений, в котором развиваются мегаспоры
Мегаспорогенез : Процесс образования мегаспор у разноспоровых растений
Медиаторы : Физиологически активные вещества, вырабатываемые нервными клетками и выделяемые в межклетное пространство, разделяющее мембраны двух взаимодействующих клеток (синаптическая щель)
Междоузлие : Участок стебля травянистого растения между двумя стеблевыми узлами
Межклетники, межклетные пространства : Полости между клетками, в которые поступают и по каналам циркулируют продукты жизнедеятельности клеток
Мезенхима : Зародышевая ткань, дающая начало разным структурным компонентам взрослого организма: соединительной ткани, форменным элементам крови, висцеральному скелету, пигментным клеткам и др
Мезодерма : Средний зародышевый листок (между экто- и эндодермой) у многоклеточных животных (кроме губок и кишечнополостных), образующийся в процессе гаструляции
Мезозой : Вторая (мезозойская) эра фанерозоя, которая предшествует кайнозою
Мезофилл : Средняя часть листа, расположенная между верхним и нижним эпидермисом
Мезофиты : Растения, занимающие промежуточное положение по отношению к содержанию воды в почве между ксерофитами и гидрофитами
Мейоз : Способ деления половых клеток растений и животных, в ходе которого осуществляется редукция числа хромосом вдвое
Меланизм : Накопление большого количества темного пигмента
Мембраны биологические : Основной структурный компонент живых клеток, липопротеиновый комплекс (пленка), ограничивающий поверхность самой клетки и большинства ее органоидов
Менделизм : Учение о закономерностях наследования признаков, разработанное Г
Меристема : Образовательная ткань растений, клетки которой длительное время сохраняют способность к делению и образованию новых клеток
Мерозигота : Неполная зигота, которая содержит только часть генома клетки-донора ДНК
Метаболизм : Обмен веществ; совокупность реакций синтеза и расщепления сложных химических соединений с участием разнообразных биологических катализаторов, сопровождающихся энергетическим обменом
Метагенез : Чередование полового и бесполого поколений в цикле развития некоторых живых организмов (некоторых кишечнополостных, червей и др
Метамерия : Тип организации в некоторых группах животных и растений, при котором тело расчленено на сходные сегменты
Метаморфоз : Тип развития организма, при котором происходит глубокое преобразование строения и смена образа жизни на последовательных стадиях онтогенеза
Метионин : Незаменимая серосодержащая аминокислота, входящая в состав многих белков
Миграция : Перемена местообитания животными, вызываемое сменой условий жизни или переходом к новой стадии развития (личинка
Миграционные волны : Крупные переселения, вызванные природными или общественными катаклизмами
Миелоциты : Клетки кроветворной ткани красного костного мозга, из которых образуются зернистые лейкоциты (гранулоциты)
Микология : Наука, изучающая особое царство живых организмов
Микориза : Симбиоз грибов (главным образом, базидиальных) с корнями высших растений
Микронуклеус : Генеративное ядро инфузорий
Микропиле : 1) пыльцевход, канал на вершине семяпочки высших растений, образующийся при смыкании ее покровов (интегументов)
Микроспора : Гаплоидная клетка, продукт мейотического деления микроспороцита у разноспоровых папоротников, плаунов и семенных растений
Микроспорангий : Орган, в котором формируются микроспоры
Микротрубочки : Структурный элемент скелета эукариотических клеток
Микрофаг : Одна из форм зернистых лейкоцитов (гранулоцитов), способная к фагоцитозу, т
Микрофауна : Животные мельче 500 мкм
Микрофиламенты : Структурный элемент, образующий наряду с микротрубочками скелет эукариотических клеток
Микрофлора : Совокупность различных микроорганизмов, которые населяют определенную среду обитания и принимают участие в круговороте веществ в данной экосистеме
Микроэволюция : Совокупность генетических процессов, протекающих на уровне популяций и приводящих в итоге к видообразованию
Микроэлементы : Химические элементы, содержащиеся в организмах в низких концентрациях, но абсолютно необходимые для их нормальной жизнедеятельности
Мимикрия : Приспособительная или защитная реакция организма, в результате которой он приобретает сходство с другим организмом или предметом окружающей среды
Митоз  &ndash; основной способ деления эукариотических клеток, сопровождающийся сложной реконструкцией ядерного аппарата. биологический смысл митоза состоит в точной передаче дочерним клеткам полного набора хромосом материнской клетки. с этой целью перед началом деления в клетке удваивается количество днк (см. интерфаза). митоз состоит из 4 фаз: профазы, метафазы, анафазы и телофазы. в начале профазы в ядре появляется клубок из тонких хроматиновых нитей. постепенно в результате конденсации хроматина нити укорачиваются и утолщаются, образуя митотические хромосомы. каждая хромосома состоит из двух дочерних половинок (хроматид) : Результат прошедшего удвоения ДНК
Митохондрия : Органоид эукариотических клеток, место синтеза основного количества энергии в форме АТФ
Мицелий : Грибница, вегетативное тело гриба (таллом), образованное переплетенными нитями
Мобильные генетические элементы : Участки в составе геномов про- и эукариот, которые характеризуются нестабильной локализацией
Модификация : Фенотипическое изменение организма под воздействием факторов внешней среды, Модификации не затрагивают структуру гена, меняется лишь уровень его экспрессии
Мозаицизм : Присутствие в ткани или организме неоднородных участков
Мониторинг : Система отслеживания состояния биосферы или отдельных ее компонентов, подвергающихся антропогенному воздействию
Моногамия : Единобрачие; форма размножения животных, при которой самец спаривается за сезон с одной самкой
Монокультура : Длительное возделывание на одной и той же территории одной и той же с/х культуры
Моносомия : Геномная мутация; отсутствие в диплоидном наборе хромосом одной хромосомы
Моноспермия : Участие в процессе оплодотворения яйцеклетки только одного спермия
Монофилия : Происхождение таксона любого ранга от одного общего предка, вида-родоначальника, путем дивергенции
Морганида : Единица расстояния между генами на генетической карте, названная в честь выдающегося американского генетика Т
Морула : Стадия раннего развития многих групп животных (губки, кишечнополостные, плоские черви, членистоногие, млекопитающие)
Морфогенез : Генетически контролируемый процесс формообразования в онто- и филогенезе
Морфоз : Неадаптивная мутация, вызываемая воздействием экстремальных факторов среды
Мультивалент : Хромосомная ассоциация гомологичных хромосом в мейозе полиплоидных клеток, в которой участвует более двух гомологов
Мутаген : Вещество или фактор, воздействие которого вызывает изменение в структуре ДНК или хромосомы
Мутагенез : Искусственное получение мутаций при воздействии химических или физических факторов
Мутационное давление : Процесс возникновения новых мутаций в популяции
Мутация : Резкое, скачкообразное изменение признака
Мутуализм : Форма симбиоза, которая является обоюдовыгодной для партнеров, которые чаще всего не могут существовать друг без друга
Наследственность : Присущая всем живым организмам способность передавать информацию о развитии своему потомству и тем самым обеспечивать преемственность и непрерывность существования жизни
Наследуемость : Это доля генетически обусловленной изменчивости в общей фенотипической изменчивости организмов
Настии : Изменение формы или положения органов растения при изменении действия факторов внешней среды
Нейробласты : Клетки-предшественники, из которых дифференцируются нейроны
Нейрон : Основной структурный элемент нервной системы
Нейрула : Стадия эмбриогенеза хордовых животных, следующая за гаструлой
Нейтральная теория эволюции : Эволюционная концепция, выдвинутая японским генетиком М
Нейтрофилы : Одна из форм зернистых лейкоцитов позвоночных животных
Некробиоз : Омертвение клеток и тканей в результате нарушения обмена веществ
Некрофаги : Животные, питающиеся трупами других животных
Нектарники : Желёзки в цветке растений, выделяющие сахаристый ароматный сок , привлекающий животных-опылителей и способствующий перекрестному опылению
Неодарвинизм : Эволюционная концепция, созданная А
Неоламаркизм : Эволюционная концепция, созданная на основе теории Ж
Неолит : Последняя в истории человечества эпоха каменного века (10
Неотения : Задержка развития на личиночной стадии с приобретением личинкой способности к половому размножению
Нимфа : Завершающая стадия развития членистоногих с неполным превращением
Нитрофилы : Организмы, хорошо растущие на среде с высоким содержанием соединений азота (некоторые водоросли, мхи, грибы, а также лен, подсолнечник, крапива и др
Номогенез : Эволюция на основе закономерностей; эволюционная концепция, выдвинутая Л
Ноосфера : Сфера разума, стадия в развитии биосферы, на которой главным фактором становится разумная деятельность человека
Нуклеазы : Ферменты класса гидролаз, катализирующие расщепление фосфодиэфирных связей в полинуклеотидных цепочках с образованием моно- и олигонуклеотидов
Нуклеиновые кислоты : ДНК  и РНК (рибонуклеиновая кислота); фосфоросодержащие биополимеры, которые представляют собой цепочки из повторяющихся мономеров
Нуклеоид : Зона расположения хромосомы (ДНК) в бактериальной клетке
Нуклеопротеиды : Соединения нуклеиновых кислот с белками, составляющие структурную основу эукариотических хромосом, рибосом, вирусных частиц
Нуцеллус : Центральная часть семяпочки (семязачатка) покрытосеменных растений, гомологичная мегаспорангию папоротниковидных
Нуцеллярная эмбриония : Одна из форм адвентивной эмбрионии, развитие у растений добавочных зародышей из соматических клеток нуцеллуса
Облигатный : Постоянно встречающееся явление, например, облигатные апомикты
Обмен веществ : См
Овизм : Одна из преформистских теорий XVIII&nbsp;в
Овуляция : Фаза полового цикла млекопитающих и человека
Однодомность : Развитие на одном растении женских и мужских цветков, как, например, у кукурузы, березы, дуба и др
Окислительное фосфорилирование : Процесс образования молекул АТФ из АДФ и фосфорной кислоты в митохондриях с использованием энергии, освобождающейся при окислении питательных веществ
Околоцветник : Совокупность листочков, окружающих репродуктивные органы цветка
Олигомеризация : Процесс сокращения в филогенезе числа гомологичных органов путем их утраты, слияния или смены функции частью гомологов
Олиготрофы : Микроорганизмы и растения, обитающие на обедненной питательными веществами среде
Онкогены : Гены, вызывающие развитие злокачественных опухолей
Онтогенез : Индивидуальное развитие особи от зарождения до смерти
Оогамия : Процесс слияния женских (яйцеклеток) и мужских (сперматозоидов, спермиев) половых клеток, отличающихся друг от друга по размеру, форме, поведению и половой принадлежности
Оогенез : Процесс развития зрелой женской гаметы (яйцеклетки), начиная с заложения первичных половых клеток
Оогоний : 1) женский половой орган у водорослей и низших грибов с оогамным половым процессом
Ооцит : Вторичная женская половая клетка животных, которая проходит этапы роста и созревания
Оператор : Участок в составе бактериального оперона, который является мишенью для белка
Оперон : Генетическая единица в составе бактериального генома, состоящая из группы генов, контролирующих какой-либо биохимический процесс
Оплодотворение : Процесс слияния женской и мужской половых клеток, характерный для всех организмов, размножающихся половым способом
Опыление : Процесс переноса пыльцы растения из пыльника на рыльце пестика  или семяпочку (у голосеменных), где происходит ее прорастание с образованием пыльцевой трубки
Органогенез : Образование органов из недифференцированных зачатков
Органоиды : Постоянно присутствующие в клетке структуры, выполняющие определенные жизненно важные функции
Орнитофилия : Опыление растений птицами, характерное для представителей ряда семейств покрытосеменных, главным образом тропических (миртовых, банановых, бобовых, лилейных и др
Ортогенез : Эволюционная концепция, отрицающая творческую роль естественного отбора в эволюции и считающая эволюцию изначально целенаправленным процессом, регулируемым исключительно внутренними факторами
Осморегуляция : Поддержание постоянной концентрации осмотически активных веществ во внутренней среде организма
Остеобласты : Незрелые клетки костной ткани, которые синтезируют материал волокон и основного вещества костной ткани
Остеоциты : Зрелые клетки костной ткани, состоящие из тела и отростков
Оцепенение : Реакция животных на наступление неблагоприятных условий жизни
Париетальный : Пристеночный, примыкающий к стенке органа слой клеток или орган, примыкающий к стенке полости тела (например, париетальный слой клеток в пыльнике, примыкающий к эпидермису; серозная оболочка
Палеозой : Первая эра фанерозоя (палеозой &rarr; мезозой &rarr; кайнозой), эра активного горообразования и интенсивной эволюции высших растений
Палеолит : Древнейший период каменного века, в течение которого сменилось несколько видов рода Ноmо, которые представляют последовательные ступени в эволюции Н
Палеонтология : Наука, изучающая ископаемые остатки живых организмов и на основе этого реконструирующая условия жизни, видовой состав, направление эволюции различных жизненных форм, обитавших на Земле в разные геологические периоды
Палингенез : Термин предложен Э
Палинология : Раздел геоботаники, изучающий пыльцу и споры растений, в том числе ископаемые
Палисадная ткань : Столбчатая паренхима листа, образующая субэпидермальные слои мезофила (обычно в верхней части листа) и состоящая из вытянутых клеток, расположенных перпендикулярно к плоскости листа
Пангенезис : Гипотеза Ч
Панмиксия : Свободное скрещивание особей внутри популяции
Панспермия : Гипотеза о происхождении жизни на Земле в результате заноса живых организмов из космических тел с космической пылью или метеоритами
Парабиоз : 1) потеря тканью (нервной, мышечной) способности к проведению возбуждения при сильных или экстремальных воздействиях; 2) искусственное сращение животных обычно с объединением их кровотоков с целью изучения их взаимовлияния на гуморальном уровне
Паразитизм : Форма межвидовых отношений, имеющая характер антогонизма
Парамутация : Межаллельное взаимодействие генов, при котором один аллель (парамутагенный) вызывает изменение другого (парамутабильного)
Парасексуальный процесс : Аналог полового процесса, слияние соматических клеток с генетически неоднородными ядрами
Парасексуальная , соматическая (от греч. soma : Тело) ГИБРИДИЗАЦИЯ
Паренхима : Основная ткань растений, состоящая из тонкостенных изодиаметрических клеток и выполняющая ряд важнейших функций, в первую очередь синтез и запасание органических веществ
Партеногенез : Развитие нового организма из неоплодотворенной яйцеклетки
Партенокарпия : Развитие плодов без оплодотворения
Патогенность : Болезнетворность, т
Педогенез : Развитие яйцеклетки без оплодотворения еще в теле личинки
Пенетрантность : Частота фенотипического проявления гена у особей с одинаковым генотипом внутри популяции
Пепсин : Фермент желудочного сока позвоночных животных
Пептиды : Органические соединения, молекулы которых состоят из остатков аминокислот, соединенных в цепь пептидной связью
Перисперм : Дополнительная к эндосперму запасающая питательная ткань в семенах растений
Перицикл : Первичная меристема в корнях и стеблях молодых растений, располагающаяся под эпидермисом вокруг центрального цилиндра
Пермеазы : Транспортные белки, участвующие в переносе веществ через мембраны
Пестик : Женский репродуктивный орган в цветке покрытосеменных растений, образованный одним или несколькими плодолистиками
Пестицид : Ядохимикат, химическое соединение, которое используется для защиты растений и с/х продукции от вредителей и переносчиков заболеваний
Пикноз : Некробиотические изменения в структуре ядер стареющих клеток, предшествующие их гибели
Пили : Нитевидные выросты на поверхности бактериальных клеток
Пиноцитоз : Процесс захвата и поглощения клеточной мембраной капелек жидкости с растворенными в ней или взвешенными органическими веществами
Пиримидиновые основания : Производные пиримидина, входящие в состав нуклеиновых кислот, а также коферментов, играющих важную роль в обмене углеводов и липидов
Плазмиды : Внехромосомные молекулы ДНК, способные к автономному существованию и воспроизведению в клетке
Плазмогены : Гены, относящиеся к ДНК митохондрий, хлоропластов и др
Плазмодесмы : Цитоплазматические нити, проходящие через поры в клеточной мембране растений и соединяющие их между собой
Плазмодий : Вегетативное тело миксомицетов, представляющее собой лишенную оболочки многоядерную цитоплазму
Плазмодий : Вегетативное тело миксомицетов, представляющее собой лишенную оболочки многоядерную цитоплазму
Плазмолиз : Отставание протопласта от оболочки растительной клетки
Плазмон : Совокупность генов, локализованных в цитоплазматических носителях наследственной информации
Пластиды : Органоиды растительных клеток, места синтеза и запасания органических веществ
Пластом : Совокупность генов, локализованных в пластидной ДНК
Плацента : У животных
Плейотропия : Множественное действие гена, влияние его на развитие нескольких признаков
Плод : 1) у покрытосеменных растений плод
Плодолистик : Генеративная структура в цветке покрытосеменных, гомологичная мегаспорофиллу, образующая пестик
Плоидность : Количество гаплоидных наборов хромосом, которые содержит отдельная клетка или все клетки организма
Подвой : Растение, к которому прививают орган вегетативного размножения  другого растения
Пойкилотермные животные : Холоднокровные животные с непостоянной температурой тела, зависящей от внешних условий
Полиандрия : Участие в оплодотворении самки животного (некоторые насекомые, птицы) нескольких мужских особей
Полигены : Совокупность генов, отвечающих за развитие одного количественного признака, например, продуктивности, высоты растений и пр
Полигиния : Многоженство; спаривание самца в сезон размножения с несколькими самками
Полимеразы : Класс ферментов, катализирующих образование биополимеров из низкомолекулярных соединений
Полимеризация : 1) процесс увеличения в филогенезе животных и растений количества гомологичных органов в организме
Полиморфизм : Морфологическое разнообразие особей, которое проявляется на популяционном или видовом уровнях в существовании резко отличимых по какому-либо признаку форм
Полипептиды : Полимеры с молекулярным весом до 6000, состоящие из соединенных в цепь аминокислотных остатков
Полиплоидия : Явление увеличения числа хромосом
Полирибосома : Комплекс рибосом, участвующих в синтезе одной белковой молекулы, объединенных одной иРНК
Полиспермия : Проникновение в яйцеклетку в процессе оплодотворения нескольких сперматозоидов
Политения : Образование гигантских или политенных (многонитчатых) хромосом в ядрах соматических клеток некоторых двукрылых насекомых, простейших и растений
Полифилия : Происхождение данной систематической группы от нескольких неродственных предков
Полиэмбриония : Многозародышевость
Поллинии : Группы пыльцевых зерен, склеенных особым веществом
Половое размножение : Основной способ размножения животных и высших растений, в основе которого лежит формирование женских и мужских  половых клеток (гамет) и их последующее слияние в процессе оплодотворения с образованием зиготы
Половой диморфизм : Существование в пределах вида двух половых форм особей
Половой отбор : Форма естественного отбора, действующая у высших животных с хорошо развитой нервной и сигнальной системами  и направленная на усиление различий между полами
Половой фактор : Бактериальная плазмида, внехромосомная молекула ДНК, определяющая участие бактериальной клетки в качестве мужского партнера &ndash; донора ДНК в процессе конъюгации
Половой хроматин : Гетерохроматические участки половых хромосом , определяющие различия в структуре интерфазных ядер у особей женского и мужского пола
Половые гормоны : Биологически активные вещества из разряда стероидов или полипептидов, регуляторы функций половых органов и полового поведения
Половые хромосомы : Хромосомы, принимающие активное участие в определении пола, наборы которых у женских и мужских особей различаются
Полулетали : Вредные мутации, имеющие отодвинутый во времени летальный эффект, который проявляется не на стадии зиготы, а на разных стадиях развития организма
Полярные тельца : Клетки-спутники яйцеклетки, которые образуются в оогенезе в результате мейоза ооцита I порядка
Популяция : Группа особей одного вида, населяющая определенную территорию
Порогамия : Способ проникновение пыльцевой трубки в зародышевый мешок растений через микропиле
Порода : Искусственно созданная человеком популяция домашних животных одного вида, характеризующаяся общим происхождением и стабильным наследованием основных биологических признаков
Прайд : Устойчивая группа особей в популяции львов, состоящая из нескольких самок и возглавляемая чаще всего одним самцом
Преадаптация : Наличие у организмов скрытых адаптивных потенций, позволяющих им осваивать новые места обитания
Презумптивный зачаток : Группа клеток в теле раннего зародыша, из которой развивается тот или иной орган взрослой особи
Преформизм : Учение о предобразовании, предсуществовании в семени зародыша, имеющего все признаки взрослого организма
Привой : Часть одного растения , пересаженная на другое (подвой), а также наземная часть растения, выросшая из нее
Прилистники : Парные придатки основания листа, обычно имеющие вид пленок
Примордий : Зачаток листа в виде меристематического бугорка на конусе роста побега
Прионы : Инфекционные белковые частицы, обнаруженные в клетках позвоночных животных и человека, являющиеся переносчиками ряда заболеваний нервной системы
Прицветники : Кроющие листья на оси соцветия, из пазух которых выходят цветки
Провизорные органы : Временные органы у зародышей и личинок животных, исчезающие при дальнейшем развитии
Провирус : Стадия в развитии ретровирусов и некоторых бактериофагов (профаг), когда их геном встраивается в бактериальную хромосому и ведет себя как ее часть
Прогестерон : Женский стероидный гормон позвоночных, играющий важную роль в половом цикле: он подготавливает матку к имплантации яйцеклетки и ее питанию
Продуценты : Автотрофные организмы, фотосинтезирующие или хемосинтезирующие органические вещества из неорганических
Прокариоты : Организмы, клетки которых не имеют структурно оформленного ядра
Проксимальный : Расположенный ближе к центру
Пролиферация : Процесс размножения клеток, обеспечивающий рост ткани или органа и компенсирующий потерю части клеточного состава в результате их гибели по тем или иным причинам
Промотор : Участок в начале каждого гена, отвечающий за связывание фермента РНК-полимеразы, ведущей транскрипцию
Пронуклеус : Женское и мужское ядро в оплодотворенной яйцеклетке до наступления кариогамии и образования синкариона
Протандрия : Одна из форм дихогамии; созревание пыльников раньше рылец пестиков в цветке
Протеазы : Ферменты, катализирующие расщепление пептидных связей в белковых молекулах (протеолитические ферменты)
Протеиды : Сложные белки, содержащие в своем составе небелковый компонент
Протеины : Простые белки, представляющие собой цепочку из остатков разных аминокислот
Протогиния : Созревание рылец пестиков в цветке раньше, чем пыльников
Протоплазма : Внутреннее содержимое клетки, включающее цитоплазму и ядро
Протопласт : Растительная клетка, лишенная клеточной стенки и окруженная только мембраной
Протромбин : Важнейший химический компонент свертывания крови , содержащийся в плазме крови и представляющий собой сложный белок
Профаг : Скрытая неинфекционная форма существования умеренных бактериофагов (см
Профаза : См
Процессинг : Важнейший этап процесса реализации генетической информации, в течение которого происходит формирование зрелых молекул разных типов РНК  из первичных транскриптов (проРНК)
Псаммон : Совокупность мелких организмов, обитающих во влажных песках вблизи рек и озер выше уровня воды
Псаммофит : Растения, обитающие в зыбучих песках и имеющие различные приспособления к такому образу жизни (мощные придаточные корни, подземные побеги в виде корневищ, летучие плоды и пр
Псевдогамия : У покрытосеменных растений тип апомиксиса, при котором яйцеклетка развивается партеногенетически, а эндосперм из оплодотворенной центральной клетки
Псевдогены : Это нефункционирующие реликтовые гены, произошедшие в результате мутационных изменений от некогда активных генов
Псевдомиксис : Особый тип размножения, при котором происходит слияние двух клеток, не дифференцированных по признаку пола
Психрофил : Холодолюбивый организм, нормально живущий и размножающийся при относительно низких температурах (от +5 до &ndash;10&deg;&nbsp;С)
Психрофит : Холодостойкое растение, растущее на влажных почвах высоких широт и высокогорий
Пуф, пуфф : Функционирующий участок гигантской или политенной хромосомы, имеющий вид вздутия
Пыльник : Верхняя часть тычинки, состоящая из двух пыльцевых мешков, соединенных связником
Пыльца : Совокупность пыльцевых зерен, образующихся в гнездах пыльника
Пыльцевое зерно : Мужской гаметофит семенных растений, который развивается из микроспоры в микроспорангии
Радиационный мутагенез : Разновидность индуцированного мутагенеза; процесс возникновения мутаций под воздействием различных излучений
Радиопротекторы : Химические вещества, обладающие антимутагенной активностью, способные защитить клетки от повреждающего действия ионизирующих излучений
Раздражимость : Одно из важных свойств живых клеток, тканей и организмов, способность реагировать на изменения внешней и внутренней среды
Размножение : Важнейшее свойство живых организмов, обеспечивающее воспроизводство и увеличение количества особей данной популяции или вида
Разновидность : Внутривидовая таксономическая категория, занимающая промежуточное положение между подвидом и формой
Рамка считывания : Способ считывания информации с ДНК, начиная с фиксированной стартовой точки и далее в соответствии с линейной последовательностью кодонов
Раса : 1) человеческая раса
Растения : Царство живых организмов, которые в подавляющем большинстве случаев являются фотосинтезирующими автотрофами
Растительность : Совокупность растительных сообществ  Земли и отдельных ее регионов
Реверсия : Повторная мутация гена, возвращающая его к исходному состоянию, обычно к проявлению дикого фенотипа
Ревертаза, обратная транскриптаза, рнк-зависимая днк-полимераза : Фермент ретровирусов, геном которых представлен РНК
Регенерация : Восстановление организмом утраченных или поврежденных органов или тканей, а также возобновление целого организма из отдельных его частей, клеток, тканей
Регресс : Направление эволюции, приводящее к упрощению строения и развития живых организмов
Регулятор : 1) вещество, регулирующее скорость протекания тех или иных процессов в живых системах
Редукция : 1) исчезновение органа или ткани или их недоразвитие: а) в процессе онтогенеза (например, редукция некоторых тычинок в цветке, редукция одной семядоли у двудольных растений), б) в процессе филогенеза в результате утраты ими функционального значения в связи с изменением условий существования (например, утрата китообразными волосяного покрова и задних конечностей вследствие приспособления их к обитанию в водной среде); 2) редукция хромосом
Редупликация : Удвоение количества ДНК в клетке
Редуценты : Организмы, главным образом бактерии и грибы, осуществляющие деструкцию органических веществ до более простых неорганических соединений
Резерват : 1) охраняемый природный комплекс, в котором объектом охраны является один из его компонентов (например, Баргузинский заповедник является резерватом соболя); 2) место временного скопления некоторых животных, связанного с циклом их развития (например, саранчи)
Резистентность : Устойчивость, невосприимчивость организма к действию каких-либо факторов или агентов (например, радиорезистентность, устойчивость к ядам и т
Резус-фактор, rh-фактор : Антиген, из разряда липопротеидов, обнаруженный у людей при введении им сывороток животных, иммунизированных эритроцитами макаки-резус
Рекапитуляция : Повторение в индивидуальном развитии организма признаков, присущих взрослой стадии предков
Рекомбинация : Передача от родителей к потомству новых комбинаций родительских генов
Рекон : Минимальная единица генетической рекомбинации, впервые определенная в 1957&nbsp;г
Релаксация днк : Процесс раскручивания суперспирали ДНК, осуществляемый ферментами
Реликты : Сохранившиеся от существовавших в прошлые геологические эпохи флор и фаун  виды (или другие систематические таксоны)
Ренатурация : Обратный переход молекулы биополимера (например, ДНК или белка) из денатурированного (неактивного) состояния в нативное (биологически активное)
Репарация : Процесс восстановления нарушений в структуре ДНК, случайно возникающих в ходе процессов репликации и рекомбинации, а также являющихся результатом каких-либо воздействий (например, облучения)
Репликационная вилка : Точка, в которой цепи родительской двухцепочечной молекулы ДНК расходятся, для того чтобы могла происходить репликация
Репликация : Процесс самовоспроизведения молекул нуклеиновых кислот (ДНК и РНК)
Репликон : Единица репликации ДНК
Реплисома : Мультиферментный комплекс, формирующийся в репликационной вилке для осуществления синтеза ДНК
Репрессор : Белок, регулирующий работу оперона
Репродукция : 1) репродукция ДНК
Реституционное деление : Тип деления эукариотических клеток, при котором дочерние клетки получают нередуцированное число хромосом
Рестриктазы : Обширный класс ферментов, способных осуществлять разрывы в одиночных или двойных цепях молекулы ДНК с образованием фрагментов
Рестрикционная карта : Линейная последовательность сайтов , в которых ДНК расщепляется различными рестриктазами
Ретикуляциты : Клетки соединительной ткани, обладающие высокой фагоцитарной способностью
Ретровирусы : РНК-содержащие вирусы, цикл размножения которых проходит через стадию двухцепочечной ДНК
Рефлекс : Ответная реакция организма на воздействие внешних или внутренних раздражителей, осуществление которой контролируется центральной нервной системой (ЦНС)
Рефлекторная дуга : Совокупность элементов нервной системы, участвующих в осуществлении рефлекса
Рецепторы : Специальные чувствительные образования на концах нервных волокон или в составе сенсорных органов, воспринимающие и преобразующие в нервные импульсы раздражения, поступающие из внешней или внутренней среды
Рецессивность : Отсутствие фенотипического проявления у одного из двух аллельных генов в гетерозиготном генотипе
Реципрокное скрещивание : Совокупность двух скрещиваний с разной комбинацией родительских форм
Рибоза : Пятиуглеродный циклический моносахарид, входящий в состав молекулы РНК
Рибонуклеазы : РНК-азы, ферменты из группы нуклеаз, расщепляющие фосфодиэфирные связи в молекуле РНК
Рибонуклеиновые кислоты : Нуклеиновые кислоты, содержащие, в отличие от ДНК, углеводный компонент
Рибосома : Клеточный органоид, осуществляющий синтез белка
Ризоид : Нитевидные корнеподобные образования у мхов, лишайников, некоторых водорослей и грибов, выполняющие функции корневой системы (прикрепление, всасывание воды и питательных веществ)
Ризосфера : Слой почвы, окружающий корни растений и богатый микроорганизмами, привлекаемыми выделениями из корней
Ро-фактор : Белок, помогающий РНК-полимеразе прекращать транскрипцию
Рыльце : Верхняя часть пестика в цветке, воспринимающая пыльцу
Сайленсеры : Участки регуляции процесса транскрипции у эукариот
Сайт : Месторасположение мутации на генетической карте
Сальтации : Внезапные, скачкообразные изменения организмов, приводящие к быстрому видообразованию
Самонесовместимость : Неспособность растений производить семена при самоопылении
Самоопыление : Способ опыления растений, при котором рыльце пестика опыляется пыльцой того же цветка или другого цветка того же растения
Саморегуляция : Способность живых клеток и организмов самостоятельно поддерживать относительно постоянный уровень процессов жизнедеятельности
Самостерильность : См
Сантиморганида : Единица расстояния между генами на генетической карте, определяемая по частоте кроссинговера
Сапротрофы : Организмы, которые питаются органическими веществами мертвых тел
Сателлитная днк : Особая фракция ДНК в составе генома эукариот, которая отличается от основной ДНК по плотности
Сахароза : Дисахарид, состоящий из остатков глюкозы и фруктозы
Свертывание крови : Защитная реакция организма, предотвращающая кровопотерю при травмах сосудов
Сегрегация : 1) сегрегация хромосом
Седиментация рибосом : Метод осаждения рибосом при ультрацентрифугировании, разработанный Сведбергом
Секреция : Образование и выделение биологически активных веществ из клеток или органов секреции
Сексдукция : Перенос бактериальных генов в процессе конъюгации из одной клетки в другую с помощью F-фактора (половой фактор)
Селекция : Прикладная наука, которая разрабатывает методы создания новых сортов растений, пород животных и штаммов микроорганизмов
Семя : Орган размножения и расселения семенных растений, формирующийся из семязачатка  либо после оплодотворения (при половом размножении), либо без него (при апомиксисе)
Семядоли : Провизорные органы зародыша, имеющие листовую природу, модифицированные в связи с выполняемыми функциями (защитная, запасающая, трофическая, фотосинтезирующая и др
Семязачаток, семяпочка : Орган семенного размножения, формирующийся в завязи, в котором протекают важнейшие процессы, лежащие в основе формирования семени
Семянка : Сухой, нераскрывающийся, односемянный плод с тонким кожистым околоплодником, не срастающимся с семенем
Сердцевина : Центральная часть стебля и корня семенных растений, состоящая из рыхлой паренхимы
Серозная оболочка : Оболочка, выстилающая внутренние полости тела животных и человека (брюшина, плевра и др
Серотонин : Образующийся в нейронах из аминокислоты триптофана гормон-медиатор, регулирующий моторику желудочно-кишечного тракта и выделение слизи
Серповидноклеточная анемия : Тяжелое наследственное заболевание, вызванное рецессивной мутацией, нарушающей первичную структуру &beta;-цепи гемоглобина
Сибсы : Потомки одной родительской пары, родные братья и сестры
Симбиогенез : Гипотеза о происхождении клеток и организмов путем симбиоза
Симбиоз : Живая система, состоящая из двух (или более) различных организмов, тесно связанных друг с другом тем или иным типом взаимоотношений (трофическими, пространственными и др
Симпатрия : Частичное или полное совпадение ареалов видов или внутривидовых генетически дифференцированных таксонов (биологических рас)
Симпласт : Многоядерное образование; ткань, не имеющая клеточного строения (например, поперечно-полосатые мышечные волокна)
Синантропные организмы : Виды растений и животных, обитающие рядом с человеком, с его жильем или в специально приспособленных им местах (тараканы, клопы, мухи, мыши, воробьи, голуби и др
Синантроп : Ископаемый человек, остатки черепа и костей которого, принадлежащие к среднему плейстоцену, найдены впервые в Китае
Синапс : Область контакта между нервными, мышечными, секреторными клетками, которая служит для проведения импульсов возбуждения или торможения
Синапсис : Конъюгация гомологичных хромосом в профазе мейоза I
Сингамия : Процесс слияния яйцеклетки и спермия (сперматозоида)
Синептенемальный комплекс : Специфическая трехполосная структура, образующаяся между конъюгирующими хромосомами  в начале профазы I мейоза и удерживающая их в соединенном состоянии до завершения кроссинговера (стадия диплотены)
Синергиды : Две сестринские клетки, входящие вместе сяйцеклеткой в состав яйцевого аппарата в зародышевом мешке покрытосеменных
Синкарион : Ядро зиготы, образующееся в результате слияния женского и мужского пронуклеусов у морских ежей и некоторых червей
Синкарпный гинецей : Пестик, образованный несколькими сросшимися плодолистиками
Синус : Пазуха, углубление, впадина, выпячивание, расширение, длинный замкнутый канал (мозговые, аортальные, венозные синусы и др
Систола  &ndash; стадия сердечного цикла, во время которой происходит сжимание полостей сердца и выбрасывание крови в артериальную систему (60 : 70&nbsp;мл за одну систолу, 7200&nbsp;л за сутки)
Склеренхима : Механическая ткань растений, состоящая из толстостенных, обычно одревесневших клеток двух типов
Ситовидные трубки : Проводящие элементы флоэмы семенных растений, состоящие из соединенных в ряд удлиненных клеток, на концах которых находятся ситовидные пластинки
Склерофит : Растение с жесткими побегами и листьями, покрытыми кутикулой, которая препятствует испарению
Скрещивание : Один из основных приемов в селекции растений и животных, когда в качестве родительских форм при получении потомства используются генетически разнородные особи
Смертность : Одна из динамических характеристик популяции, которая выражается числом особей, умерших за определенный период по отношении к условному их числу
Смерть : Полное прекращение процессов жизнедеятельности в организме, сопровождающееся необратимыми изменениями клеток и тканей
Соединительная ткань : Ткань, входящая в состав внутренней среды организма, с хорошо развитыми межклеточными структурами в виде коллагеновых и др
Сома : Тело организма; совокупность всех клеток организма, за исключением половых
Соматическая гибридизация : Процесс слияния соматических клеток, принадлежащих разным, часто генетически очень отдаленным организмам
Соматическая нервная система : Часть периферической нервной системы, состоящая из чувствительных и двигательных нервных волокон, иннервирующих опорно-двигательный аппарат и кожу
Сорт : Совокупность сходных по хозяйственно-ценным морфологическим признакам или биологическим свойствам растений одного вида, родственных по происхождению, отобранных и размноженных для возделывания в определенных условиях
Соплодие : Совокупность сросшихся плодов, развившихся из отдельных цветков соцветия и образующих при прорастании несколько проростков
Соцветие : Побег, несущий цветки
Социал-дарвинизм : Идеологическая концепция, объясняющая историческое развитие общества биологическими законами борьбы за существование и естественного отбора
Спейсеры : Некодирующие участки в составе эукариотических геномов, в основном играющие роль разграничителей генов и кластеров генов
Сперматида : Гаплоидная мужская половая клетка, продукт мейотического деления сперматоцита I порядка
Сперматогенез : Процесс развития сперматозоидов &ndash; мужских половых клеток животных, человека и многих растений (у высших растений этот процесс обычно называют спермиогенезом)
Сперматогонии : Диплоидные мужские половые клетки на первой стадии сперматогенеза, характеризующейся их интенсивным митотическим делением
Сперматозоид : Зрелая мужская половая клетка животных и человека, а также водорослей, мхов и др
Сперматофор : Капсула, заполненная зрелыми сперматозоидами, склеенными выделениями придаточных желез
Сперматоцит : Мужская половая клетка на этапе роста  и созревания (сперматоцит II порядка)
Спермий : Гаплоидная мужская половая клетка семенных растений, образующаяся в результате митотического деления генеративной клетки пыльцевого зерна
Сплайсинг : Сшивание экзонов в молекулу иРНК в процессе ее созревания
Споры : Репродуктивные клетки грибов и низших растений, которые служат для размножения и расселения
Спорангий : Одноклеточный (у грибов и многих низших растений) или многоклеточный (у высших растений) репродуктивный орган, в котором образуются споры
Спорополленин : Высокомолекулярный биополимер, содержащийся в оболочке пыльцевого зерна (экзине) и придающий ей прочность
Спорофилл : Видоизмененный лист хвощей, плаунов и высших растений, на котором формируются микро- и макроспорангии
Спорофит : Бесполое поколение в цикле развития растений с чередованием поколений
Спячка : Физиологическое состояние организма, для которого характерно резкое снижение интенсивности всех жизненных процессов
Старение : Закономерный процесс возрастных изменений организма, ведущий к снижению его жизнедеятельности и адаптационного потенциала
Стволовые клетки : Клетки-родоначальники в обновляющихся клеточных популяциях
Стебель : Осевой вегетативный орган высших растений, несущий листья, почки и цветки
Стенобионт : Организм, живущий в строго определенных условиях существования: в определенных границах температуры, влажности, давления, солености почвы и т
Стерильность : Частичная или полная неспособность организма продуцировать жизнеспособные гаметы, приводящая к снижению или полной потере плодовитости
Столон : Видоизмененный подземный (у картофеля и тюльпана) или надземный побег (у земляники и лютика) с длинными тонкими междоузлиями и чешуевидными, бесцветными листьями
Строма : 1) опорная структура органов животных, состоящая из неоформленной соединительной ткани
Структурные гены : Гены, кодирующие клеточные белки с ферментативными или структурными функциями
Субстрат : 1) основа (почва, грунт водоемов, скалы и т
Суккуленты : Ксерофитные растения с сочными листьями или стеблями, накапливающие в паренхиме большое количество влаги (кактусы, агавы, алоэ, молочаи и др
Суперспирализация днк : Структурная форма двуцепочечной молекулы ДНК, в которой она образует супервитки, пересекая при этом собственную ось
Супрессия : Явление подавления экспрессии мутантного аллеля мутацией другого гена
Таксис : Движение свободно передвигающихся организмов по направлению к действующему стимулу (положительный таксис) или в сторону от него (отрицательный таксис)
Таксон : Обособленная группа родственных организмов, которой можно присвоить определенный таксономический ранг
Таксономический ранг, категория : Понятия (вид, род, семейство, тип и пр
Талассемия : Наследственное заболевание , обусловленное различными мутациями, снижающими или полностью подавляющими синтез &alpha;- или &beta;-цепи глобина
Таллом : Слоевище; вегетативное тело водорослей, грибов, лишайников, не расчлененное на органы и не имеющее настоящих тканей
Тапетум : Выстилающий слой пыльников, играющий основную роль в обеспечении питательными веществами развивающейся пыльцы и формировании спородермы
Таутомерные основания : Одна из форм азотистых оснований  в молекуле ДНК
Телергоны : Вещества, выделяемые животным во внешнюю среду и воздействующие на других животных того же (фермоны) или другого вида (кайромоны, алломоны)
Телитокия : Партеногенетическое рождение потомства, состоящего исключительно из самок (например, весеннее поколение тлей)
Теломера : Концевой участок хромосомы, состоящий из многократно повторяющихся коротких блоков нуклеотидов
Теломорфоз : Направление эволюции в сторону узкой специализации
Телофаза : Завершающая стадия деления клетки (митоза или мейоза), на которой хромосомы достигают полюсов
Телоцентрическая хромосома : Хромосома, состоящая из одного плеча и центромеры, образующаяся при разрыве обычной двуплечей хромосомы по границе центромерного участка
Тератомы : В широком смысле
Терминальный : Расположенный на конце
Терминатор : Нуклеотидная последовательность, находящаяся на конце транскриптона (участка транскрипции), ответственная за прекращение процесса транскрипции
Терминация : Завершающая фаза процесса транскрипции, в которой фермент РНК-полимераза, катализирующий этот процесс, отсоединяется от матрицы самостоятельно или с участием специфического белка (&amp;ro;-фактора)
Терморегуляция : Поддержание организмом оптимальной температуры тела
Термофилы : Организмы, обитающие в среде с постоянно высокой температурой
Тестостерон : Основной мужской половой гормон, стероидной природы, определяющий дифференциацию организма по мужскому типу
Тетрада : Группа из четырех гаплоидных клеток растений (тетрада спор), образующаяся в результате мейоза микро- или мегаспороцита
Тетрадный анализ : Разновидность гибридологического анализа, основанная на исследовании продуктов мейоза
Тетраплоид : Организм, в клетках которого присутствуют четыре гаплоидных набора хромосом
Тимин, 5-метилурацил : Пиримидиновое основание, входящее в состав нуклеотидов ДНК
Тихогенез : Эволюция организмов, основанная на случайных изменениях, подвергающихся естественному отбору
Ткань : Совокупность клеток, сходных по происхождению, строению и функциям, образующих вместе с межклетниками единую систему
Толерантность : 1) терпимость организма по отношению к воздействию какого-либо фактора внешней среды; 2) отсутствие или снижение остроты иммунной реакции на появление в организме определенного антигена
Тонопласт : Мембрана, ограничивающая вакуоль растительной клетки
Тонус : Оптимальное функциональное состояние организма, которое поддерживается благодаря постоянно поступающим в ЦНС импульсам
Топоизомеразы : Группа ферментов, осуществляющих топологические перестройки ДНК , необходимые для осуществления процессов репликации, рекомбинации и транскрипции
Торможение : Подавление процесса возбуждения, которое осуществляется либо на уровне периферической нервной системы в синапсах железистых и мышечных клеток, либо реализуется в ЦНС
Тотипотентность : Способность клеток реализовать генетическую программу развития в разных направлениях, вплоть до образования целого организма
Точковые мутации : Изменение одной пары оснований в молекуле ДНК
Транзиция : Точковая мутация, при которой пуриновое основание замещается другим пурином (или пиримидин
Трансверсия : Точковая мутация, при которой пурин заменяется на пиримидин или пиримидин на пурин, т
Трансдукция : Способ переноса информации от одной бактериальной клетки к другой с помощью бактериофагов
Транскрипция : Перенос генетической информации с ДНК на молекулу иРНК
Транслокация : Хромосомная мутация, межхромосомная перестройка; перенос участка хромосомы на другую хромосому (нереципрокная транслокация) или обмен концевыми участками между негомологичными хромосомами (реципрокная транслокация)
Трансляция : Синтез белка по матрице информационной РНК в соответствии сее генетическим кодом
Транспирация : Физиологический процесс испарения воды растением, благодаря которому осуществляется регулирование водного баланса и температурного режима растения
Трансплантация : Пересадка ткани или органа растения, животного или человека либо на другое место в этом же организме, либо от донора к реципиенту
Транспозиция : Перемещение нуклеотидных последовательностей, так называемых мигрирующих элементов из одного сайта в другой
Транспозон : Мобильный генетический элемент про- и эукариот, состоящий из нескольких тысяч пар нуклеотидов и содержащий в своем составе помимо участков ДНК, отвечающих за транспозицию, различные структурные гены
Транспорт веществ : Поступление и перемещение различных веществ в клетках и в организме, доставка их по проводящей системе к органам и тканям, а также выведение продуктов обмена веществ
Трансфекция : Явление переноса генетической информации у эукариот, аналогичное трансформации у бактерий
Трансформация : Изменение наследственных свойств клеток под влиянием включения в геном чужеродной ДНК
Трансформизм : Естественно-научная и философская концепция об изменяемости органического мира, предшествовавшая эволюционному учению
Триплет : Последовательность из трех азотистых оснований в молекуле ДНК или РНК, определяющая включение в молекулу белка в процессе ее синтеза определенной аминокислоты
Триптофан : Незаменимая аминокислота, входящая в состав многих белков, гормонов, пигментов, алкалоидов
Троглобионты : Организмы, обитающие в пещерах, пещерных водоемах и подземных водах
Тромбоциты : Форменные клеточные элементы крови позвоночных, участвующие в процессе ее свертывания
Тропизмы : Направленные ростовые движения растений, происходящие под влиянием какого-либо фактора среды, действующего как раздражитель: света, температуры, влажности, гравитации и пр
Трофическая цепь : Система, состоящая из отдельных групп организмов, связанных между собой пищевыми отношениями по принципу: пищевой ресурс
Тургор : Давление внутриклеточной жидкости на оболочку, делающее ее упругой и эластичной
Тычинка : Мужской генеративный орган в цветке растений, состоящий из тычиночной нити и пыльника
Убиквисты : Организмы, для которых характерна широкая экологическая амплитуда
Убихиноны : Коферменты, участвующие в процессах окислительного фосфорилирования
Углеводы : Важнейшие химические компоненты живой клетки с общей формулой CnH2nOn
Узел : 1) место на стебле растений, откуда растут листья, почки или придаточные корни и через который проходят проводящие пучки; 2) лимфатические узлы
Ультраабиссаль : Зона океанических глубин, лежащая ниже 6000&nbsp;м (граница морского дна), наиболее бедная жизнью
Унивалент : Хромосома, которая остается неспаренной с гомологичной хромосомой в профазе I мейоза
Универсалии : Врожденные типы поведения, которые могут быть поняты представителями всех рас и всех культур
Уровни организации живых систем : Молекулярно-генетический, клеточный, организменный, популяционный, видовой, биоценотический и биосферный
Уродства : Пороки развития живых организмов, проявляющиеся чаще всего в период эмбриогенеза
Усик : Лист, часть листа или стебля, видоизмененные в тонкую спиралевидную структуру, которая служит для закрепления стебля на опоре
Условный рефлекс : Неврожденная приспособительная реакция организма, возникающая в ответ на действие условного раздражителя и закрепляющаяся в результате его повторных действий
Устьице : Специализированные структуры на поверхности листа (в эпидермисе), регулирующие процесс транспирации и газообмена
Фагосома : Пузырек, ограниченный однослойной мембраной, с содержимым, поглощенным клеткой в процессе эндоцитоза
Фагоцитоз : Один из вариантов эндоцитоза
Фагоциты : Специализированные клетки соединительной ткани, осуществляющие фагоцитоз (микрофаги, макрофаги)
Фактор фертильности : Половой фактор бактерий, представленный крупной плазмидой, наличие которой позволяет бактериальной клетке играть роль донора ДНК в процессе конъюгации
Факультативный : Возможный, необязательный
Фанерогамы : Явнобрачные растения; цветковые растения с хорошо развитыми органами размножения
Фанерозой : Период явной жизни, включающий три эры: палеозой, мезозой и кайнозой
Фанерофиты : Жизненная форма растений, почки возобновления которых располагаются высоко над землей и в зонах с неблагоприятными условиями защищены от внешних воздействий чешуями (деревья, кустарники, деревянистые лианы)
Фасетки : Простые глазки или омматидии; структурная единица сложных глаз ракообразных, насекомых и др
Фасциация : Срастание друг с другом частей растения (стеблей, цветков, плодов, соплодий и пр
Фасция : Оболочка из соединительной ткани, покрывающая внутренние органы и мышцы позвоночных, в которой проходят кровеносные сосуды и нервы
Фауна : Совокупность видов животных, обитающих на определенной территории
Феллема, пробка : Внешний водозащитный слой перидермы, образованный феллогеном
Феллоген, пробковый камбий : Слой меристематических клеток, который делится и откладывает внутрь феллодерму, а наружу &ndash; феллему
Феллодерма : Слой клеток, образованный феллогеном и примыкающий к первичной коре
Феминизация : Проявление у мужских особей вторичных половых признаков женского пола
Фен : Элементарный наследственный признак, альтернативные формы которого (например, гладкие и морщинистые семена гороха) наследуются по моногибридной схеме (менделирующие признаки)
Фенетика : Раздел биологии, изучающий закономерности распространения и появления фенов
Фенилаланин, l-&beta;-фенил-&alpha;-аминопропионовая кислота : Незаменимая аминокислота, входящая во все природные белки, кроме протаминов
Фенилкетонурия : Наследственная болезнь, обусловленная рецессивной мутацией, блокирующей обмен фенилаланина на одной из стадий его превращений
Фенокопия : Ненаследственное изменение, модификация, сходная по внешнему проявлению с мутацией
Фенология : Наука о сезонных изменениях в развитии растений и животных, о зависимости сроков наступления и продолжительности разных фаз развития (фенофаз) от факторов внешней среды (температуры, освещенности, влажности и пр
Фенотип : Совокупность всех внешних и внутренних признаков и свойств организма, которые формируются за период онтогенеза на основе взаимодействия генотипа и внешней среды
Ферменты, энзимы : Биологически активные вещества белковой природы, катализирующие все процессы обмена веществ в клетке
Феромоны : Специфические биологически активные вещества, выделяемые животными в окружающую среду и влияющие на поведение или физиологическое состояние других животных
Фертильность : Способность организма к производству потомства на основе формирования нормальных половых клеток и оплодотворения
Фетализация : Сохранение у взрослых организмов некоторых систематических групп ряда эмбриональных признаков в результате эволюционного замедления темпов их развития
Фибрин : Белок, конечный продукт свертывания крови, структурная основа тромба
Фибриноген : Гликопротеид плазмы крови, который под действием фермента тромбина превращается в фибрин
Фибробласт : Основной клеточный элемент соединительной ткани животных, в котором синтезируются компоненты межклеточного вещества (коллаген, мукополисахариды)
Филаменты : Внутриклеточные фибриллярные белковые структуры, участвующие в образовании цитоскелета, в осуществлении различных форм движения и во внутриклеточном транспорте веществ
Филетическая эволюция : Возникновение прямой неветвящейся эволюционной ветви, без образования дочерних групп (т
Филогенез : Историческое развитие органического мира в целом, а также отдельных групп живых организмов (царств, типов, семейств и т
Филэмбриогенез : Эволюционное преобразование процесса индивидуального развития (эмбриогенеза) организмов
Финализм : Эволюционная концепция, в основе которой лежит постулат о запрограммированном характере эволюции, ее движении к определенной цели
Фитобентос : Совокупность растений, обитающих на дне водоема
Фитогормоны : Физиологически активные вещества, регуляторы развития растений
Фитонциды : Вырабатываемые растениями и выделяемые в окружающую среду биологически активные вещества, убивающие или подавляющие рост и развитие других организмов
Фитотрон : Сооружение, представляющее собой полностью автоматизированную установку, в которой создается искусственный микроклимат для выращивания растений
Фитофаги : Животные, питающиеся исключительно или почти исключительно растениями (многие насекомые, рыбы)
Фитоценоз : Устойчивое сообщество видов растений, занимающих определенный биотоп и связанных общим круговоротом веществ
Флавоноиды : Фенольные соединения, присутствующие в клетках высших растений
Флора : Совокупность видов растений, обитающих или обитавших в прошлые эпохи на определенной территории
Флоэма : Проводящая ткань растений, по которой продукты фотосинтеза транспортируются из листьев к местам потребления или отложения в запас
Флуктуация : Форма модификационной изменчивости, состоящая в плавном, постепенном изменении признака с незначительным отклонением от средней его величины
Фолликулы : Многослойные полые образования в виде мешочка, присутствующие в разных органах позвоночных (щитовидная железа, сальные железы, лимфатические железы и пр
Фосфопротеиды : Важнейший класс сложных белков живой клетки, участвующих в регуляции активности ядра, окислительных процессах в митохондриях, в ионном транспорте и пр
Фосфорилирование : Реакция включения в молекулу вещества фосфатной группировки, которая идет с поглощением большого количества энергии и образованием макроэргических связей
Фотопериодизм : Реакция растений на изменение светового режима в течение суток (т
Фотосинтез : Совокупность реакций синтеза органических веществ в растениях с использованием энергии солнечного света
Фототропизм : Ростовые изгибы органов растений под влиянием одностороннего освещения
Фрагмопласт : Клеточная пластинка, зачаток клеточной стенки, возникающий в центре экваториальной плоскости делящейся клетки
Фуникулюс : Семяножка, нижняя часть семяпочки, соединяющая ее с семяносцем или плацентой
Хазмогамия : Опыление в раскрытых цветках, свойственное ксеногамным растениям
Халаза : Основание семяпочки (семязачатка), где она сливается с интегументами и семяножкой в единую структуру
Халазогамия : Один из способов проникновения пыльцевой трубки в семяпочку, минуя микропиле через халазу
Хеморецепторы : Чувствительные нервные окончания, воспринимающие химические раздражения
Хемосинтез : Процесс синтеза некоторыми видами бактерий, как аэробными, так и анаэробными, органического вещества из углекислого газа за счет энергии, получаемой при окислении неорганических соединений (аммиака, сероводорода, закиси железа и др
Химера : Организм-мозаик, тело которого состоит из разнородных клеток, участков или органов
Хитин : Сложный полисахарид, составляющий опорную основу тела беспозвоночных животных
Хлоренхима : Паренхимная ткань растений, клетки которой содержат хлоропласты и осуществляют фотосинтез
Хлоропласты : Специализированные органоиды растительной клетки, зеленые пластиды, в которых осуществляется фотосинтез
Хлорофилл : Зеленый пигмент растений, с помощью которого они улавливают солнечную энергию и осуществляют фотосинтез
Холестерин : Важный мультифункциональный химический компонент животных клеток, относящийся к классу стероидов
Хондриом : Геном митохондрий; совокупность генов, содержащихся в ДНК митохондрий, которая составляет менее 1% от всей ДНК клетки
Хондроциты : Зрелые хрящевые клетки, образующиеся из хондриобластов, от которых отличаются меньшей синтетической активностью
Хорион : 1) наружная оболочка зародышей высших позвоночных, включая человека
Хроматида : Копия хромосомы, формирующаяся в предмитотической и предмейотической интерфазе в результате удвоения ДНК
Хроматин : Интенсивно окрашивающиеся основными красителями структуры интерфазного ядра, представленные участками деконденсированных хромосом, сохранившими состояние плотной спирализации, и ядрышками
Хроматофоры : Органоиды водорослей, аналогичные хлоропластам, содержащие пигменты, обеспечивающие фотосинтез
Хромомеры : Утолщенные, плотно спирализованные участки хромосомы, расположение которых по ее длине строго специфично, что создает неповторимый рисунок хромосомы, напоминающий нитку с бусинками
Хромонема : Нить, составляющая структурную единицу хромосомы
Хромопласт : Растительные пластиды с красной, желтой и оранжевой окраской
Хромопротеиды : Сложные окрашенные белки, цвет которых зависит от их спектра поглощения
Хромосома : Основная структура ядра эукариотической клетки, материальный носитель наследственной информации
Хромоцентр : Крупный гетерохроматический участок интерфазной хромосомы, находящийся в состоянии плотной спирализации
Царство : Высшая таксономическая категория в системе организмов
Цветок : Репродуктивный орган цветковых растений
Цветоложе : Осевая часть цветка, верхняя часть цветоножки, из которой растет цветок
Цветоножка : Часть стебля, на которой растет цветок
Целлюлоза, клетчатка : Природный полимер, полисахарид, входящий в состав клеточных стенок растений и некоторых беспозвоночных и придающий им прочность
Целом : Вторичная полость тела многоклеточных животных (моллюсков, высших червей, иглокожих, хордовых идр
Ценоз : Любое сообщество живых организмов
Центриоль : Органоид животной клетки, входящий вместе с центросферой в состав клеточного центра или центросомы
Центромера : Первичная перетяжка на теле хромосомы, разделяющая ее на два плеча
Центросома : Клеточный центр, обычно состоящий из двух центриолей, окруженных поляризованным слоем цитоплазмы (центросферой)
Церебральный : Имеющий отношение к головному мозгу
Циклоз : Движение цитоплазмы внутри клетки, сопровождающееся перемещением веществ и органоидов
Циста : Временная форма существования многих одноклеточных (и некоторых многоклеточных организмов), в которой они покрываются плотной защитной оболочкой
Цис-транс-тест, тест на комплементацию : Метод генетического анализа, позволяющий определять принадлежность двух рецессивных мутаций либо к одному гену, либо к разным
Цистрон : Генетическая единица функции, которая устанавливается с помощью цис-транс-теста
Цитозин : Пиримидиновое основание, входящее в состав нуклеиновых кислот у всех организмов
Цитокинез : Деление цитоплазмы клетки после завершения деления ядра в митозе или мейозе
Цитокинины : Ростовые гормоны растений, регуляторы обмена веществ, которые синтезируются в меристеме , откуда поступают во все части растения
Цитолиз : Процесс ферментативного переваривания содержимого клетки, осуществляемый с участием лизосом
Цитомиксис : Объединение ядерного материала двух соседних соматических клеток
Цитоплазма : Внутреннее содержимое клетки, исключая ядро
Цитотомия : См
Цмс : Цитоплазматическая мужская стерильность растений, вызванная мутациями митохондриальных генов , ответственных за нормальное функционирование тапетума
Чашечка : Наружная часть двойного околоцветника, образованная сросшимися или свободными чашелистиками, имеющими листовое происхождение
Человек : Биосоциальное существо, продукт сложного и длительного естественно-исторического и общественного развития
Человечество : Совокупность людей, населяющих Землю
Чередование поколений : Смена полового и бесполого поколений в жизненном цикле растений и животных
Черенкование : Форма вегетативного размножения с помощью части стебля
Чувствительность : Способность живых организмов воспринимать и реагировать на внешние и внутренние раздражения
Шизогония : Форма бесполого размножения у простейших (фораминифер, споровиков) и некоторых водорослей, при которой ядро материнской клетки (шизонта) делится на несколько ядер, а затем клетка распадается на соответствующее число одноядерных клеток
Шок : Резкое нарушение нервной регуляции жизненных процессов, вызванное воздействием чрезвычайного раздражителя
Штамбовые формы : Форма растений (например, розы), у которой цветы и плоды собраны на верхушке стебля
Штамм : Генетически однородная (чистая) культура в пределах данного вида микроорганизмов, которая характеризуется определенными свойствами (например, вирулентностью, колициногенностью и пр
Щиток : 1) единственная семядоля злаков, которая имеет вид зеленого пластинчатого образования, отделяющего в семени зародыш от эндосперма
Эволюция : Процесс исторического развития живой природы
Эврибионты : Организмы, живущие в различных, иногда резко отличающихся условиях среды
Эгоистическая днк : Фракция ДНК в составе генома эукариот, единственной функцией которой является самовоспроизведение
Эдификаторы : Виды растений, определяющие основные свойства фитоценозов: состав, структуру, продуктивность, фитосреду
Экваториальная пластинка : Фигура, которую образуют хромосомы делящейся клетки на стадии метафазы митоза или мейоза, когда они выстраиваются в экваториальной плоскости веретена деления
Эквационное деление : Второе деление мейоза, при котором набор хромосом делится надвое и равномерно распределяется между дочерними клетками
Экзина : Внешняя оболочка пыльцевого зерна, которая состоит в основном из спорополленина
Экзоны : Участки в составе эукариотических генов с прерывистой структурой, несущие информацию о структуре разных частей (доменов) белка, кодируемого данным геном
Экзонуклеазы : Ферменты, последовательно отщепляющие нуклеотиды с концов полинуклеотидной цепи
Экологическая ниша : Часть местообитания сообщества, занимаемая конкретным видом, в которой представлены все факторы, необходимые для его существования
Экологическая сукцессия : Последовательная смена видового состава сообщества, наблюдающаяся при освоении новых территорий, например лесной гари
Экосистема : Природный комплекс, образованный живыми организмами и средой их обитания, в основе которого лежит тесное взаимодействие всех его компонентов
Экотип : Совокупность растений одного вида, приспособленных к определенным условиям местообитания и характеризующихся наследуемыми адаптивными признаками, обусловленными экологическими причинами
Экспрессивность : Степень фенотипического проявления гена
Эксцизия : Процесс вырезания фрагмента молекулы ДНК в процессе транспозиции или репарации
Эктогенез : Эволюционная концепция додарвиновского периода развития биологии, рассматривающая процесс эволюции как результат реализации изначальной способности живых организмов целесообразно реагировать на изменения условий внешней среды
Эктодерма, эктобласт : Наружная зародышевая ткань (зародышевый листок) у многоклеточных животных
Элайопласты : Пластиды (разновидность лейкопластов), в которых запасаются масла
Элиминация : 1) гибель организмов в результате экстремальных воздействий факторов внешней среды или в результате борьбы за существование; 2) элиминация хромосом
Эмбрион : Животный организм в ранний период развития от оплодотворения до рождения
Эмоции : Внешние проявления реакций организма с высокоразвитой вегетативной нервной системой на воздействие различных внешних и внутренних факторов
Эндемики : Вид или любой другой таксон, имеющий ограниченную область распространения
Эндодерма : Внутренний слой клеток первичной коры в стеблях и корнях растений, окружающий центральный цилиндр
Эндодупликация : Процесс удвоения хромосом в клетке без вступления ее в митоз
Эндомитоз : Внутриядерный митоз, при котором удвоившиеся в период интерфазы хромосомы претерпевают процесс конденсации и приобретают вид митотических хромосом, состоящих из двух хроматид
Эндонуклеазы : Ферменты, расщепляющие связи между нуклеотидами внутри молекулы нуклеиновой кислоты
Эндоплазматическая сеть : Мембранный органоид клетки, впервые обнаруженный с помощью электронного микроскопа в 1945&nbsp;г
Эндотелий : 1) специализированный слой клеток, называемый также интегументальным тапетумом, который образуется из внутреннего интегумента и окружает зародышевый мешок
Эндотеций : Прилегающий к наружнему эпидермису слой стенки пыльника, состоящий из вытянутых клеток с удлиненными ядрами и толстыми неэластичными оболочками
Энтодерма, энтобласт : Внутренний зародышевый листок многоклеточных животных, из которого в дальнейшем формируются эпителий основной части кишечника и связанные с ним железы (печень, поджелудочная железа и др
Энтойкия : Форма комменсализма, при которой один организм (энтойк) обитает в теле другого (хозяина), не нанося ему вреда
Энтомофилия : Перекрестное опыление у растений, осуществляемое насекомыми
Энхансеры : Участки в составе генома эукариот, регулирующие экспрессию структурных генов на уровне транскрипции
Эпиболия : Обрастание; морфогенетическое движение, одна из форм гаструляции и перемещения клеточных пластов
Эпигенез : Учение, рассматривающее зародышевое развитие организмов как процесс постепенных качественных изменений, последовательного формирования органов зародыша из изначально недифференцированной субстанции
Эпидермис : 1) наружный слой кожи животных, состоящий из однослойного (у беспозвоночных) или многослойного (у позвоночных) эпителия
Эпикантус : Образованная кожей верхнего века характерная складка в углу глаза человека, относящегося к монголоидной расе
Эпикотиль : Надсемядольное колено, участок стебля проростка между семядолями и первым листовым узлом
Эписома : Бактериальная плазмида, способная встраиваться в хромосому бактерии
Эпиойкия : Форма комменсализма, при которой один организм живет на поверхности другого, не нанося ему вреда
Эпистаз : Один из типов взаимодействия неаллельных генов, при котором один ген подавляет действие другого
Эпителий : Покровная ткань многоклеточных животных, выстилающая внутренние полости тела и покрывающая его снаружи
Эпифиты : Растения, поселяющиеся на стволах и ветвях деревьев, но не наносящие им вред, так как питаются самостоятельно (печеночный мох, папоротники, орхидеи и др
Эргастоплазма : Богатые гранулярным компонентом (рибосомами) участки цитоплазмы клетки
Эритроциты : Красные кровяные клетки позвоночных и иглокожих, содержащие пигмент гемоглобин
Эстрогены : Женские половые гормоны
Эукариоты : Организмы, клетки которых содержат оформленное ядро
Эуплоидия : Кратное увеличение основного набора хромосом в клетке (три-, тетра-, пентаплоидия и т
Эухроматин : Участки хромосом, характеризующиеся слабой степенью спирализации ДНК и поэтому слабо окрашивающиеся
Эфемеры : Однолетние растения с коротким, чаще всего весенним, циклом развития
Эффект положения гена : Изменение действия гена при изменении его положения в хромосоме в результате хромосомных перестроек
Эффекторы : Органы, деятельность которых носит рефлекторный характер
Ювенильность : Неполовозрелость; возрастное состояние организма до начала функционирования генеративных органов
Ядро : Обязательная часть эукариотической клетки, отделенная от цитоплазмы двойной мембраной (см
Ядрышко : Специализированная структура ядра эукариотической клетки
Яйцеклетка : Женская половая клетка, которая после оплодотворения или путем партеногенеза дает начало новому организму
Яйцо : Яйцеклетка животных вместе с окружающими ее яйцевыми оболочками
