Полярная шапка : Область на поверхности планеты, отличающаяся наличием низкой температуры, обусловленной малым количеством солнечной энергии, и покрытая льдом определённого химического состава.
Полярные регионы : Это территории, располагающиеся южнее  или севернее (для Арктики) полярных кругов.
Полярный день : Период, когда Солнце не заходит за горизонт дольше 1 суток.
Полярный круг : Воображаемая линия на поверхности планеты, параллель, что проходит ровно посередине широтного пояса, в котором бывает полярный день, но не бывает полярной ночи.
Потамоним : Собственное имя любой реки.
Природные ресурсы : Совокупность объектов и систем живой и неживой природы, компоненты природной среды, окружающие человека и используемые им в процессе общественного производства для удовлетворения материальных и культурных потребностей человека и общества.
Регион : Слово (термин, в отдельных науках), используемое для обозначения участка суши или воды, который можно отделить от другого участка (например, того, внутри которого он находится) по ряду определённых критериев.
Рельеф : .
Роза ветров (картография) : Образное название картографического обозначения основных географических азимутов сторон горизонта в виде звезды с количеством лучей, кратным четырём.
Север : Сторона света, соответствующая направлению на Северный полюс.
Северное полушарие : Часть Земли, расположенная к северу от экватора.
Сезонно-талый слой : Слой почвы или горных пород, протаивающий в тёплый период года, ограниченный снизу многолетнемёрзлыми породами (ММП).
Селитебные земли : Земли, предназначенные для строительства жилых и общественных зданий, дорог, улиц, площадей в пределах городов и посёлков городского типа.
Синтетическая биогеография : География экосистем и биоценозов, современное направление биогеографических исследований характеризующееся привлечением комплексных и количественных методов широкого круга географических и биологических дисциплин на базе комплексных и количественных показателей.
Спелеоним : Вид оронима.
Стороны света : Одно из четырёх основных направлений .
Страна : Территория, имеющая политические, физико-географические, культурные или исторические границы, которые могут быть как чётко определёнными и зафиксированными, так и размытыми .
Субарктический пояс : Природный географический пояс в севеграничащий с арктическим поясом (арктикой) на севере и умеренным поясом на юге.
Субэкваториальный пояс : «под» и лат.
Судоходность : .
Суша : Часть поверхности планеты Земля, не покрытая водами Мирового океана и другими водными объектами.
Термический экватор : Это широтная полоса с наиболее высокими средними многолетними температурами воздуха у земной поверхности .
Термокарст : Тепло и нем.
Термоэрозия : Термин, использующийся для обозначения эрозии в области многолетней  мерзлоты.
Территория : Часть поверхности суши с определёнными границами.
Топографическая карта : Географическая карта универсального назначения, на которой подробно изображена местность.
Топоним : Разряд онимов, имя собственное, обозначающее собственное название природного объекта на Земле или объекта, созданного человеком на Земле.
Тропики : Климатические зоны Земли.
Тропический пояс : Се́верный тропи́ческий пояс и ю́жный тропи́ческий по́яс .
Тропопауза : Слой атмосферы, в котором происходит резкое снижение вертикального температурного градиента, естественный переходный слой между тропосферой и стратосферой.
Угол места : Угловая высота наблюдаемого объекта (земного предмета, летательного аппарата, небесного светила и др.
Условные знаки (картография) : Система знаковых графических обозначений , применяемая для изображения на картах различных объектов и явлений, их качественных и количественных характеристик.
Устье : Конечный участок реки, место впадения реки в водохранилище, озеро, море, океан или другую реку .
Ущелье : Глубокая горная долина с отвесными неприступными склонами.
Филателистическая география : Направление коллекционирования почтовых марок, когда коллекционеры ставят своей целью собрать по одной или по несколько марок каждой страны, территории, местной почтовой службы, всех периодов политического управления каждого отдельного государства.
Хороним : Собственное имя любой территории, имеющей определённые границы: небольшого пространства (луг, лес, городской район), исторической области, административного района или страны.
Части света : Регионы суши, включающие материки или их крупные части вместе с близлежащими островами.
Широта : Координата в ряде систем сферических координат, определяющая положение точек на поверхности Земли и других небесных тел, а также на небесной сфере .
Экватор : .
Экономико-географическое положение : Вид географического положения, определяемый как «совокупность пространственных отношений предприятий, населённых пунктов, ареалов, районов, отдельных стран и их групп к внешним объектам, имеющим для них экономическое значение».
Экспозиция склона : Одна из морфометрических характеристик рельефа, характеризующая пространственную (по отношению к сторонам света) ориентацию элементарного склона холма, горы или горного хребта.
Эоловые формы рельефа : Форма рельефа,  cформированный разрушительной или аккумулирующей деятельностью ветра за счёт песчаных и пылевых частиц переносимых ветром[уточнить].
Юг : Сторона света, противоположная северу, совпадает с направлением на южный полюс.
Южное полушарие : Часть Земли, расположенная к югу от экватора.
Южный полюс : Точка пересечения оси вращения Земли с её поверхностью в Южном полушарии.
Параллель : Линия сечения поверхности планеты плоскостью, параллельной плоскости экватора.
Перекат : Мелководный участок русла реки.
Перелетки : Маломощные мёрзлые толщи, существующие более одного года.
Пересыпь : Низкая и узкая полоса наносной суши  из песка или гальки, отделяющая лиман или лагуну от моря либо большого озера.
Пересыхание : Прекращение стока воды в русле.
Плотность населения : Число жителей, приходящееся на 1 км² территории.
Подножие (география) : Переходная относительно узкая полоса, отделяющая склон от окружающего его рельефа.
Пойменная многорукавность : Обобщающее название разных типов разветвлённых русел с разными типами русловых процессов в них.
Полуостров : Часть суши, с трёх сторон омываемая водой , а четвёртой примыкающая к материку, острову.
Полушарие воды : Представляет собой полушарие Земли, с центром, расположенным по координатам 47°13′ ю.
Полушарие суши : .
Полушария Земли : Две половины сферической поверхности Земли, которые выделяют по определённым признакам.
Польдер : Осушенный и возделанный низменный участок побережья.
Поляна : Открытый участок в лесу.
Поляризованный ландшафт : Концепция культурного ландшафта с территориальной структурой, предполагающей гармоничное сосуществование природных зон и деятельности человека.
Область (административная единица) : Административно-территориальная единица Армении, Белоруссии , Болгарии (област), Казахстана (облыс), Киргизии (облус) и Украины (область), единица федерального деления современной России.
Ороним : Собственное название любого объекта рельефа земной поверхности: как выпуклого (гора, горный хребет, холм), так и вогнутого (долина, овраг, впадина, ущелье, котлован), то есть любого орографического объекта; класс топонима.
Осерёдок : Наносное отложение в русле реки, не имеющее растительности и не примыкающее к берегу, которое во время высокого уровня воды затапливается, образуя мель, а в межень осыхает, превращаясь в невысокий остров.
Остров : Участок суши  в океане, море, озере или на реке, окружённый со всех сторон водой и постоянно возвышающийся над водой даже в период наибольшего прилива.
Островная дуга : Цепочки вулканических островов над зоной субдукции, возникающие там, где одна океаническая плита погружается под другую.
Относительная высота вершины : Характеристика горной вершины, часто используемая для решения, считать ли её самостоятельной горой.
Относительная транспортирующая способность потока : Руслоформирующий критерий, являющийся отношением транспортирующей способности потока и поступления наносов.
Населённый пункт : Населённое людьми место (поселение), первичная единица расселения людей в пределах одного застроенного жильём земельного участка.
Неоландшафт : Антропогенный ландшафт, возникновение которого связано с глубоким воздействием человека на уже существующий ландшафт.
Неотопоним : Переименованные по разным причинам топонимы .
Магнитное склонение : Угол между географическим и магнитным меридианами в точке земной поверхности, который показывает отличие между показаниями магнитного компаса и истинным направлением на север в данной точке земной поверхности в данную историческую эпоху.
Макрорегион : «большой», лат.
Малый город : Это поселение, которое больше, чем сельский населённый пункт, но меньше, чем крупный город.
Мель : Возвышение дна в море, реке, озере, затрудняющее судоходство.
Меридиан : Применяемый в географии и астрономии термин, обозначающий линию сечения поверхности плоскостью, проходящей через ось вращения или симметрии.
Место слияния : .
Мировой океан : Основная часть гидросферы, непрерывная, но не сплошная водная оболочка Земли, окружающая материки и острова, и отличающаяся общностью солевого состава.
Многолетняя мерзлота : Часть криолитозоны, характеризующаяся отсутствием периодического протаивания.
Море : Часть Мирового океана, обособленная сушей или возвышениями подводного рельефа.
Мыс : Участок суши, выдающийся острым углом в море, озеро, реку.
Ландшафт : Конкретная территория, однородная по своему происхождению, истории развития и неделимая по зональным и азональным признакам.
Каменные моря : Обширные беспорядочные нагромождения и россыпи неокатанных каменных глыб , каменники, располагающиеся на плоских элементах рельефа и занимающие обширные пространства ниже снежной границы.
Каньон : Глубокая речная долина с очень крутыми, нередко отвесными склонами и узким дном, обычно полностью занятым руслом реки, образовавшееся в результате выветривания и эрозивной активности реки по геохронологической шкале.
Картографическая генерализация : Процесс научно обоснованного отбора и обобщения географических объектов и явлений для отображения их на карте.
Коды иерархического административного деления : Геокоды, представляющие названия административно-территориальных частей страны, таких как штаты, провинции, регионы и т.
Комоним : Деревня, селение, поселок + др.
Континент : Крупный массив земной коры, большая часть которого не покрыта водой, а окраины находятся ниже уровня океана.
Контурная карта : Особый вид учебных бланковых немых географических карт, содержащих элементы географической основы и координатную сетку.
Конус выноса : Флювиальная форма рельефа, представляющая собой крупномасштабную морфологическую структуру, созданную реками с твёрдым
донным стоком и реже .
Криотекстура : Система ледяных включений в мерзлом грунте.
Культурный ландшафт : Земное пространство, включающее все присущие ему природные и антропогенные компоненты.
Изодинама : Равный, греч.
Изотерма (метеорология) : Изолиния одинаковых температур.
Искусственный остров : Стационарное гидротехническое сооружение на открытой водной акватории (в морях, озёрах, реках), подобные острова создаются человеком, а не природой.
Золль : Небольшая, преимущественно округлая блюдцеобразная впадина-ванна, заполненная водой («мокрые» золли) или торфом.
Забереги : Полосы ледяного покрова, окаймляющие берега водотоков и водоёмов , при незамерзающей остальной части водного пространства.
Залив : Часть океана, моря, озера или другого водоёма, глубоко вдающаяся в сушу, но имеющая свободный водообмен с основной частью водоёма.
 : .
Западное полушарие : Полушарие Земли, расположенное к западу от Гринвичского меридиана и к востоку от 180-го меридиана.
Земли общего пользования : Часть поверхности суши с определёнными границами имеющая юридический статус земель общего пользования.
Ерик : Относительно узкая протока, соединяющая озёра, заливы, протоки и рукава рек между собой, а также с морем.
Датум : Набор параметров эллипсоида, референц-эллипсоида или квазигеоида, зафиксированный в определённый момент времени.
Делювий : Скопление рыхлых продуктов выветривания горных пород у подножия и у нижних частей возвышенностей.
Дримоним : «дубовая роща, лес» + др.
Дромоним : Вид топонима.
 : .
Гавайская подобласть : Подобласть Австралийской зоогеографической области суши, занимающая территорию Гавайских островов, имеющих вулканические происхождение.
Гелоним : Собственное имя любого болота, заболоченного места.
Географический детерминизм : Концепция, утверждающая, что процесс общественного развития это не результат проявления объективных закономерностей развития общества, а следствие влияния природных сил.
Географический объект : Существующие или существовавшие относительно устойчивые, характеризующиеся определенным местоположением  целостные образования Земли: материки, океаны, моря, заливы, проливы, острова, горы, реки, озера, ледники, пустыни и иные природные объекты; республики, края, области, города федерального значения, автономные области, автономные округа; города и другие поселения, районы, волости, железнодорожные станции, морские порты, аэропорты и подобные им объекты.
Географический полюс : Точка, в которой ось вращения Земли пересекается с поверхностью Земли.
Географическое положение : «положение географического объекта относительно поверхности Земли, а также по отношению к другим объектам, с которыми он находится во взаимодействии…».
Геокодирование : Процесс назначения географических идентификаторов  объектам карты и записям данных.
Геоматика : Совокупность применений информационных технологий, мультимедиа и средств телекоммуникации для обработки данных, анализа геосистем, автоматизированного картографирования.
Геопространство : «форма существования географических объектов и явлений в пределах географической оболочки; совокупность отношений между географическими объектами, расположенными на конкретной территории и развивающимися во времени».
Геосфера : Сферические оболочки (сплошные и прерывистые) формирующие планету Земля.
Гидроним : Один из классов топонимов .
Глобус : Трёхмерная модель Земли или другой планеты, а также модель небесной сферы (небесный глобус).
Годоним : Вид урбанонима .
Гора : .
Горизонт : Граница неба с земной или водной поверхностью.
Город : Крупный населённый пункт, жители которого заняты, как правило, не сельским хозяйством.
Горст : Дислокация, резко приподнятая над окружающей местностью по вертикальным или крутонаклонным тектоническим разломам (сбросам и взбросам) до нескольких сотен и тысяч метров в высоту, длиною в десятки сотен километров при ширине в десятки километров с крутыми склонами участок земной коры, ограниченный и образовавшийся вследствие тектонических движений.
Грабен : Дислокация, участок земной коры, опущенный относительно окружающей местности по крутым или вертикальным тектоническим разломам.
Восток : Сторона света, в направлении которой вращается Земля.
Восточное полушарие : Полушарие Земли, расположенное к востоку от Гринвичского меридиана и к западу от 180-го меридиана.
Высота над уровнем моря : Линейная мера разности потенциалов в точке земной поверхности и в начале счёта высот .
Базис эрозии : Уровень, на котором водный поток теряет свою энергию и ниже которого не может углубить своё русло (теряет эродирующую способность).
Байджарах : Бугры, образованные вмещающей породой (алевриты, пылеватые суглинки торф и пр.
Биогеография : Наука на стыке биологии и географии; изучает закономерности географического распространения и распределения животных, растений и микроорганизмов.
Биогеофизика : Самостоятельное направление геофизики, изучающей структуру и динамику живых сообществ  и происходящие в них процессы круговорота вещества и энергии.
Биокосное вещество : Один из типов вещества биосферы (возникшее на стыке живого и неживого), в понятии академика В.
Биофилота : Флора и фауна определённого ареала, территориальный фаунистический и флористический комплексы, наиболее чётко выражена на островах.
Болотоведение : Учение о болотах как участках земной поверхности или ландшафтах с присущими им особенностями растительного покрова, гидрологического режима и почвообразовательного процесса.
Бом (рельеф) : В Горном Алтае этим словом обозначают узкое место между рекой и горой, по которому пролегает дорога, а также скалистый обрыв, крутой обрывистый берег.
Бор (лес) : Народное название соснового леса, произрастающего на хорошо дренированных песчаных, супесчаных и легкосуглинистых почвах, в отличие от тех сосновых лесов, которые произрастают на болотах.
Агороним : Вид урбанонима, топоним для обозначения названий площадей и других открытых пространств в городах.
Агрооним : Вид топонима для обозначения названий земельных возделанных участков .
Административный центр : Официальный главный населённый пункт  любого административного образования первого, второго или третьего уровня (такого как область, край, автономная республика, провинция, штат, департамент).
Азональность : Собирательный термин, охватывающий все явления в пределах ландшафтной сферы Земли, которые напрямую обусловлены энергией земных недр (эндогенных процессов).
Анклав открытого моря : Части морских пространств, удалённые более чем на 200 морских миль от побережья и полностью окружённые экономической зоной одного или нескольких государств.
Антипод : Точка на поверхности небесного тела (например, земной поверхности), диаметрально противоположная данной.
Астионим : Вид ойконима, собственное имя города.
Географическая оболочка : Внешняя оболочка Земли , одно из глобальных и системных понятий в географии.
