Абиогенез : Возникновение живого из неживого в процессе эволюции
Абиосфера : Слои атмосферы, не испытывающие и никогда не подвергавшиеся какому бы ни было влиянию живых организмов
Австралопитек : Прямоходящая, ископаемая человекообразная обезьяна
Автогамия : Самоопыление и самооплодотворение у цветковых растений
Автополиплоидия : Наследственное изменение, заключающееся в спонтанно возникающем кратном увеличении числа набора хромосом в клетках растений
Автотроф : Организм, получаемые органические соединения из неорганических с помощью энергии Солнца
Агглютинация : Склеивание и выпадение в осадок из однородной взвеси бактерий, эритроцитов и других клеток
Агроценоз : Сообщество, созданное человеком
Адаптация : Способность организмов, приспособиться к меняющимся условиям среды
Адвентивность : Приход вида из другого сообщества
Аденин : Пуриновое основание, содержащееся в составе нуклеиновых кислот
Аденозин : Нуклеотид, состоящий из пуринового основания аденина и моносахарида рибозы
Аденома : Доброкачественная опухоль молочной, щитовидной, предстательной желез
АДФ : Аденозиндифосфат - вещество, которое образуется в результате переноса концевой фосфатной группы
Азотобактерии : Группа аэробных свободноживущих бактерий, способных фиксировать азот из воздуха и тем самым обогащать им почву
Азотофиксация : Связывание молекулярного азота атмосферы и перевод его в органические азотистые основания – аминокислоты
Акклиматизация : Приспособление какого-либо вида к новым условиям существования
Аккомодация : Приспособление глаз к рассматриванию предметов
Аккумуляция : Накопление в организмах химических веществ
Акромегалия : Чрезмерный рост конечностей и костей лица вследствие нарушения функций гипофиза
Акселерация : Резкое убыстрение полового созревания, увеличение роста
Аксон : Отросток нервной клетки, проводящий нервные импульсы от тела клетки
Акцептор : Вещество, воспринимающее электроны и водород от окисляемых соединений и передающее их другим веществам
Аллель : Различные формы одного и того же гена, расположенные в одинаковых участках (локусах) гомологичных (парных) хромосом
Альбинизм : Врожденное отсутствие нормальной для данного вида организмов пигментации
Альвеола : Пузырьки в легких, на концах бронхов
Альгология : Наука о водорослях
Аминокислота : Органическое соединение, содержащее карбоксильную и аминогруппы
Амитоз : Прямое деление ядра клетки
Амниота : Высшее позвоночное животное (пресмыкающиеся, птицы, млекопитающие), приспособленное к развитию на суше
АМФ : Аденозинмонофосфат циклический – нуклеотид
Анабиоз : Временное состояние организма, при котором жизненные процессы замедленны
Анаболизм : Физиолого-биохимические процессы, составляющие част метаболизма и направленные усвоение клеткой пищевых веществ
Анализатор : Система нервных образований, осуществляющая восприятие и анализ раздражений
Аналогия : Сходство органов или их частей, разных по происхождению, но одинаковых по функции
Анатомия : Наука, изучающая строение и функции органов
Анаэроб : Организм, способный жить в бескислородной среде
Андроген : Группа мужских половых гормонов
Анемия : Малокровие – уменьшение количества эритроцитов
Антагонист : Мышцы и их группы, действующие одновременно или поочередно в 2 противоположных направлениях
Антеридий : Гаметофит - мужской половой орган размножения у грибов, водорослей мхов и папоротников
Антибиотик : Вещество, способное убивать микроорганизмы
Антиген : Сложное органическое вещество, способное при поступлении в организм животных и человека вызвать ответную иммунную реакцию – образование антител
Антикодон : Участок молекулы транспортной РНК, состоящий из 3 нуклеотидов
Антропоген : Последний из геологических периодов, в котором возрастало воздействие человека на природу
Антропогенез : Раздел антропологии – учение о происхождении человека
Антропология : Межотраслевая дисциплина, исследующая происхождение и эволюцию человека
Аппарат Гольджи : Органоид клетки, которых участвует в формировании некоторых продуктов жизнедеятельности
Ареал : Область распространения любой систематической группы организмов
Архегоний : Женский орган размножения у мхов, папоротников, хвощей, плаунов
Ассимиляция : Одна из сторон обмена веществ, потребление и превращение поступающих в организм веществ
Асфиксия : Удушье
Атавизм : Появление у отдельных особей каких-либо признаков, которые существовали у их далеких предков, но были утрачены в процессе эволюции (хвост, волосяной покров, многососковость)
Атрофия : Прижизненное уменьшение размеров органов и тканей
АТФ : Аденозинтрифосфат – нуклеотид, образованный аденозином и 3 остатками фосфорной кислоты
Аутбридинг : Скрещивание особей одного вида, не состоящих в непосредственном родстве
Аутосома : Хромосома, морфологически идентичная со своей гомологичной парой
Аутэкология : Раздел экологии, изучающий взаимоотношения отдельной особи с окружающей средой
Ахроматин : Вещество клеточного ядра, слабо окрашиваемое при гистологической обработке
Ацидоз : Накопление в крови и других тканях организма отрицательно заряженных ионов
Аэроб : Организмы, живущие только в кислородной среде
Аэробионт : Организм, живущий в воздушной среде
Бактериология : Раздел микробиологии, изучающий бактерии
Бактериостаз : Временное прекращение роста и размножения бактерий под воздействием различных факторов
Бактериофаг : Вирус бактерий, способный поражать бактериальную клетку
Бацилла : Бактерия, имеющая форму палочки
Белок : Высокомолекулярное органическое соединение, построенное из остатков 20 аминокислот
Бентос : Совокупность организмов, всю жизнь обитающих на дне океанов
Бивалент : Две гомологичные хромосомы, образующиеся при делении клеточного деления ядра
Биогенез : Процесс возникновения живого из живого
Биогеоценоз : Ограниченная природная система, в которой в тесной связи существуют живые организмы и окружающая среда
Биоиндикатор – виды или сообщества организмов, по наличию или состоянию которых можно судить о состоянии окружающей среды. : 
Биолокация : Способность животного определять свое положение
Биолюминесценция : Видимое свечение организмов, связанное с процессами их жизнедеятельности
Биом : Совокупность видов животных и растений, составляющих живое население
Биомасса : Выраженное в единицах массы или энергии количество живого вещества тех или иных организмов, приходящееся на единицу площади
Биополимеры : Высокомолекулярные природные соединения – белки, нуклеиновые кислоты, полисахариды, служащие структурными частями живых организмов
Биосинтез : Процесс образования необходимых организму веществ, протекающий в его клетках с участием биокатализаторов – ферментов
Биотоп : Относительно однородное по абиотическим факторам среды пространство в пределах водной, наземной и подземной частей биосферы
Биоценоз : Взаимосвязанная совокупность микроорганизмов, растений, грибов и животных, населяющих однородный участок суши или водоема
Бластомеры : Очень крупные, однотипные клетки дробящегося яйца животного
Бластопор : Отверстие, посредством которого полость двухслойного зародыша животных (гаструла) с внешней средой
Бластоцель : Первичная полость тела животного на стадии бластулы
Бластула : Фаза зародышевого развития многоклеточных животных
Бриология : Наука, изучающая мхи
Вакуоль : Полость в протоплазме клетки, заполненная клеточным соком (кариоплазма)
Вакцина : Препарат из живых ослабленных микроорганизмов, применяемый для иммунизации человека или животных в лечебных целях
Вегетация : Произрастание, состояние активной жизнедеятельности растения, рост и питание
Везикула : Образование в теле организма, имеющее вид пузырька
Венчик : Внутренняя часть отдельных или сросшихся между собой лепестков двойного околоцветника
Вирус : Неклеточная форма жизни, способная проникать в живую клетку и размножаться только внутри ее
Вирусология : Наука, изучающая вирусы
Витализм : Совокупность идеалистических течений в биологии, объясняющих жизненные явления действием «жизненной силы»
Витамин : Органическое вещество, образующееся в животном организме или поступающееся в пищу для нормального функционирования
Вторичноротые : Группа животных – иглокожие, хордовые – при эмбриональном развитии рот образуется на противоположной стороне зародыша
Галлофил : Организмы, живущие с повышенным процентом соли
Галофит : Растение, обитающее на засоленных почвах и горных породах
Галлофоб : Организм, не выносящий повышенной солености среды
Гамета : Половые клетки с гаплоидным набором хромосом
Гаметангий : Половой орган, в котором образуются гаметы
Гаметогенез : Процесс образования гамет
Гаметогония : Половое размножение у простейших
Гаметофит : Представитель полового поколения или этап жизненного цикла растений от споры до зиготы
Гаметоцит : Незрелые половые клетки у простейших
Гаплоид : Клетка или особь с одинарным набором непарных хромосом
Гастроцель : Полость зародыша на стадии гаструлы
Гаструла : Фаза зародышевого развития многоклеточных животных – двухслойный мешок
Гаструляция : Процесс образования гаструлы
Гельминтоз : Заболевание организма, вызванное паразитическими червями
Гельминтология : Отрасль зоологии, исследующая паразитических червей
Гемоглобин : Красный дыхательный пигмент крови человека и животных
Гемолимфа : Жидкость, циркулирующая в незамкнутой кровеносной системе
Гемофилия : Наследственное заболевание, характеризуемое повышенной кровоточивостью, что объясняется недостатком факторов свертывания крови
Гемоцит : Любой клеточный элемент крови
Ген : Единица наследственного материала, участок молекулы ДНК
Генерация : Разовое потомство одной особи, группы или популяции
Генетика : Наука, изучающая законы наследственности и изменчивости
Геном : Совокупность генов, содержащихся в гаплоидном наборе хромосом
Генотип : Совокупность всех наследственных свойств особи
Генофонд : Совокупность генов группы особей популяции
Геофит : Многолетнее растение, почки возобновления которого находятся в подземных органах
Гербицид : Вещество, используемое для избирательного уничтожения нежелательных растений
Гермафродитизм : Наличие признаков мужского и женского пола у одной особи животного
Герпетология : Раздел зоологии, изучающий земноводных и пресмыкающихся
Гетерогамия : Тип полового процесса, при котором сливающиеся гаметы различаются по внешнему виду
Гетерогенез : Смена способов размножения у организмов на протяжении двух или более поколений
Гетерозигота : Содержание в клетках тела разных генов данной аллельной пары
Гетерозис : Ускорение роста, увеличение размеров
Гетеротроф : Организм, использующий для питания только органические вещества
Гиалоплазма : Коллоидная система, в которой расположены ядро и все органоиды
Гигрофил : Щрганизм, приспособленный к обитанию в условиях высокой влажности
Гигрофит : Наземные растения, приспособленные к обитанию в условиях избыточной влажности
Гигрофоб : Наземные животные, избегающие избыточной влажности
Гидробионт : Организм, постоянно обитающий в водной среде
Гидрофил : Организм, любящий воду
Гидрофит : Водные растения, погруженные в воду только нижними частями
Гидрофоб : Организм, избегающий воды
Гинецей : Совокупность пестиков в цветке
Гипертрофия : Чрезмерное увеличение объема органов или части тела вследствие увеличения размеров и числа клеток
Гиподерма : Слой эпителия у беспозвоночных животных, расположенный под кутикулой
Гиподинамия : Нарушение функций организма при малой двигательной активности
Гипотония : Пониженное кровяное давление
Гистология : Наука, изучающая ткани
Гиф : Одноклеточная или многоклеточная нить, образующая вегетативное и плодовое тело (мицелий и таллом) гриба
Гликокаликс : Наружный слой клетки животного организма
Гликолиз : Процесс расщепления углеводов без кислорода под действием ферментов
Гомеостаз : Состояние динамичного подвижного равновесия природной системы
Гомогамия : Одновременное созревание на одном и том же обоеполом растение мужских и женских органов, способствующее самоопылению
Гомозигота : Содержание клеткой одинаковых генов данной аллельной пары
Гомойотерм : Организм с постоянной температурой тела, которая не зависит от окружающей среды
Гомология : Сходство органов или их частей одинакового происхождения
Гормон : Биологическое активное вещество, вырабатываемое железами внутренней секреции
Гуанин : Пуриновое основание, содержащееся в клетках организмов в составе нуклеиновых кислот
Дальтонизм : Наследственная неспособность различать некоторые цвета
Двудомность : Образование женских и мужских половых органов на разных экземпляров растений одного вида
Дегенерация : Вырождение, ухудшение из поколения в поколение биологических свойств организма в результате неблагоприятных условий организма
Дезоксирибоза : Простой углевод (моносахарид)
Демэкология : Раздел экологии, исследующий взаимоотношение популяций с окружающей средой
Дерма : Нижний слой кожи мезодермального происхождения
Деструктор : Организм, разрушающий что-либо
Диакинез : Заключительная стадия профазы мейоза, во время которой хромосомы максимально укорачиваются в ходе спирализации
Дивергенция : Расхождение признаков у родственных организмов
Диплоид : Особь или клетка с 2 гомологичными наборами хромосом
Диссимиляция : Процесс разрушения органических веществ на более простые
Дифференциация : Разделение таксона на 2 или несколько частей
Доминант : Вид, преобладающий в сообществе
Донор : Организм, у которого берут часть для пересадки другому организму (акцептору)
Дрейф генов : Изменение генетической структуры популяции в результате любых случайных причин
Дупликация : Разновидность хромосомных перестроек
Железа экзокринная : Железа, имеющая выводящие протоки и выделяющая вырабатываемые ею секреты на поверхность тела
Железа эндокринная : Железа, не имеющая выводных протоков и выделяющая вырабатываемые ею вещества непосредственно в кровь
Завязь : Нижняя расширенная часть пестика, из которой образуется плод
Закон биогенетический : Онтогенез есть краткое и быстрое повторение филогенеза
Закон биогенной миграции атомов В.И. Вернадского : Миграция химических элементов на земной поверхности и в биосфере в целом осуществляется или при непосредственном участии живого вещества, или же она протекает в среде, геохимические особенности которой обусловлены живым веществом
Закон гомологических рядов наследственной изменчивости Н.И. Вавилова : Виды и роды, генетически близкие, характеризуются сходными рядами наследственной изменчивости с такой правильностью, что, зная ряд форм в пределах одного вида, можно предвидеть нахождение параллельных форм у других видов и родов. Чем ближе генетически расположены в общей системе роды, тем полнее сходство в рядах их изменчивости
Закон единообразия гибридов первого поколения : Первое поколение гибридов, в силу проявления у них лишь доминантных признаков
Закон зародышевого сходства : На ранних стадиях эмбрионального развития организмы сходны с соответствующими стадиями развития предковых и родственных форм
Закон независимого комбинирования признаков : Гены одной аллельной пары распределяются в мейозе независимо от генов других пар и комбинируются в процессе образования гамет случайно, что ведет к разнообразию вариантов их соединений
Закон расщепления гибридов второго поколения : Во втором поколении гибридов соотношение особей с доминантными и рецессивными признаками равно 3:1
Закон чистоты гамет Г. Менделя : Гамета диплоидного гибрида может нести лишь один из двух аллелей данного гена
Замор : Массовая гибель водных организмов
Заросток : Половое поколение (гаметофит) низших споровых растений
Зигота : Оплодотворенное яйцо, диплоидная клетка, образованная в результате слияния гамет
Зооспора : Подвижная клетка водорослей и некоторых грибов, служащая для бесполого размножения
Зоохор : Растение и гриб, зачатки, которых распространяются животными
Идиоадаптация : Совершенствование организмов путем частных изменений в строении органов
Изоляция : Разобщение особей друг от друга
Изомеразы : Класс ферментов, катализирующих в клетках внутримолекулярные перестройки
Имаго : Взрослая особь насекомых
Иммиграция : Вселение в какую-либо местность организмов, ранее здесь не обитавших
Иммунитет : Сопротивляемость организма к инфекционным заболеваниям
Имплантация : Внедрение зародыша высших млекопитающих в слизистую оболочку матки
Инбридинг : Близкородственное скрещивание
Ингибитор : Вещество, замедляющее протекание химических процессов
Инкубация : Время развития зародыша в яйце птицы искусственным путем
Инсайт : Элементы разумной деятельности у животных
Интеграция : Процесс соединения в раннем онтогенезе клеток генетически одинакового типа в скопления и их распределения в определенном порядке
Интерфаза : Состояние клетки между ее делением
Интерферон : Защитный белок, вырабатываемый клетками млекопитающих и птиц в ответ на заражение вирусами
Интоксикация : Отравление организма
Интродукция : Преднамеренный или случайный перенос особей какого-либо вида живого за пределы его ареала
Информосома : Внутриклеточная частица эукариот, участвующая в биосинтезе белка, состоит из РНК
Ихтиология : Раздел зоологии, изучающий рыб
Кадастр : Систематизированный свод данных, включающий качественную и количественную опись объектов или явлений
Камбий : Однорядный слой клеток образовательной ткани в стеблях и корнях двудольных и голосеменных растений
Каннибализм : Форма взаимоотношения особей одного вида, которая заключается в поедании друг друга
Канцероген : Вещество, способное вызвать злокачественное новообразование
Капилляр : Тончайший кровеносный сосуд, соединяющий артериальную и венозную системы
Капсула : Оболочка, прикрывающая органы или их части
Кариотип : Диплоидный набор хромосом в соматических клетках организма
Каротиноиды : Пигменты красного, желтого и оранжевого цвета, которые встречаются в растительных и некоторых животных тканях
Катаболизм : Биохимические процессы, направленные на распад пищевых веществ
Катагенез : Упрощение организации и образа жизни организма в результате приспособления к более стабильным условиям существования
Каталаза : Фермент, катализирующий процесс разложения токсичной перекиси водорода
Катализатор : Вещество, ускоряющее химические процессы
Кифоз : Изгиб позвоночника выпуклостью назад
Коадаптация : Взаимное приспособление в ходе эволюции
Коацерваты : Живые белковые сгустки
Колленхима : Механическая ткань из живых клеток с пластичными водосодержащими оболочками
Комменсализм : Постоянное или временное сожительство особей разных видов, извлекая одностороннюю пользу без вреда для другого
Конвергенция : Появление сходных признаков у разных организмов
Консумент : Организмы, потребляющие готовые органические вещества
Конъюгация : Обмен генетическим материалом у простейших
Копрофаг : Животное, питающееся экскрементами
Кофермент : Сложное органическое вещество небелковой природы
Креационизм : Теория божественного сотворения мира
Криофил : Организм, способный жить в условиях низкой температуры
Криофит : Растение сухих и холодных местообитаний
Кроссинговер : Обмен равными участками гомологичных хромосом
Ксантофиллы : Группа желтых красящихся пигментов, содержащихся в частях растения
Ксерофил : Организмы, способные жить в сухих местах
Ксерофит : Растение засушливых местообитаний
Ксилема : Ткань высших растений, проводит воду от корней к листьям
Кутикула : Плотная мертвая оболочка на поверхности клеток
Латентный период : Время от момента воздействия на организм какого-либо раздражителя до появления видимой ответной реакции
Латеральный : Расположение органа или части тела сбоку от оси организма
Лейкопласты : Бесцветные пластиды, встречающиеся в корневищах, клубнях
Лейкоциты : Бесцветные, подвижные клетки животных, способные захватывать и переваривать микроорганизмы
Летальный : Смертельный исход
Летаргия : Болезненный сон, длящийся от нескольких часов до нескольких часов
Лигаза : Фермент, катализирующий в клетках присоединение друг к другу двух различных молекул
Лигнин : Органическое полимерное соединение, которое содержится в клеточных оболочках сосудистых растений
Лизосома : Клеточный органоид, участвующий в переваривании белков
Лимфа : Бесцветная жидкость, которая образуется из плазмы крови
Лимфоцит : Одна из форм незернистых лейкоцитов, которая образуется в лимфатических узлах
Липид : Жироподобное вещество
Локус : Участок хромосомы, в котором локализован ген
Макронуклеус : Крупное ядро у инфузорий
Макроспора : Крупная спора, из которой развивается женский заросток (гаметофит)
Макроспорангий : Орган, в котором у споровых и семенных растений развиваются женские заростки
Макрофаг : Клетка, способная к захватыванию и перевариванию посторонних частичек. Открыл Мечников
Макрофит : Растение-макроорганизм
Макроэволюция : Процесс образования крупных таксонов
Медиатор : Вещество, молекулы которого способны реагировать со специфическими рецепторами клеточной мембраны и изменять ее проницаемость
Междоузлие : Участок стебля растения между точками прикрепления листьев
Межклетник : Полость между клетками в теле растения
Мезенхима : Соединительная ткань, возникает за счет клеток, которые выселяются из разных зародышевых листков: энто-, эндо- и мезодермы
Мезоглея : Студенистое вещество, залегающее между экто- и эндодермой у губок и кишечнополостных
Мезодерма : Серединный зародышевый листок
Мезотелий : Эпителиальная ткань, выстилающая серозные оболочки полостей тела
Мезофилл : Мякоть или основная часть листка растений
Мезофит : Растение, обитающее в условиях более или менее достаточного, но не избыточного увлажнения
Мейоз : Процесс деления гамет, в результате которого происходит уменьшение (редукция) числа хромосом
Меланизм : Явление темной окраски животных, зависящий от наличия в их покровах черных и темно-коричневых пигментов
Метаболизм : Обмен веществ
Метаморфоз : Процесс превращения ювенильных фаз развития во взрослое животное
Метафаза : Вторая стадия деления ядра
Механорецептор : Чувствительное нервное окончание, воспринимающее раздражения
Микология : Наука, изучающая грибы
Микориза : Симбиотическое обитание грибов на корнях деревьев
Микробиология : Наука, изучающая микроорганизмы
Микронуклеус : Меньшее из ядер инфузорий
Микроспора : Мелкая спора, из которой развивается мужской заросток
Микрофаг : Одна из форм лейкоцитов, способных к фагоцитозу мелких инородных частиц, в т.ч. микробов
Микрофил : Организм, выносящий только очень небольшие колебания температуры
Микрофлора : Флора микроорганизмов в сообществе
Микроэфолюция : Процесс образования популяций и подвидов
Мимикрия : Подражательность, имитирование
Миоцен : Нижнее подразделение неогенового периода
Митоз : Непрямое деление ядра клетки, в результате увеличивается число клеток
Митохондрия : Энергетическая станция клетки
Мицелий : Вегетативное тело гриба, состоящее из нитей – гифов
Многодомность : Образование двуполых и однополых цветков на одной особи растений
Модификация : Ненаследственное изменение признаков организма, возникающее под воздействием изменившихся условий окружающей его среды
Моногамия : Единобрачие, спаривание самца с одной самкой в течение одного или нескольких сезонов
Монокарпия : Растение, плодоносящее и цветущее один раз
Мутаген : Любой фактор, вызывающий мутацию
Мутагенез : Процесс возникновения мутаций
Мутация : Изменение наследственных свойств организма
Мутуализм : Форма симбиоза, при которой каждый из сожителей получает относительную равную пользу
Нейрула : Стадия развития зародыша хордовых, в которой происходит закладка из эктодермы пластинки нервной трубки
Некрофаг : Организм, питающийся мертвыми животными
Неолит : Новый каменный век
Неофит : Недавно появившийся в местной флоре вид, например сорняк
Нерест : Выметание рабами яйц
Нимфа : Последняя личиночная фаза постэмбрионального развития членистоногих, развивающихся с неполным метаморфозом
Нить ахроматиновая : Микротрубочка, входящая в состав ахроматинового веретена
Нуклеазы : Ферменты, расщепляющие нуклеиновые кислоты в живых организмах
Нуклеотид : Фосфорный эфир нуклеозида, состоящий из азотистого основания, углевода и остатка фосфорной кислоты
Овуляция : Выход яйцеклеток из яичника в полость тела
Однодомность : Образование женских (пестичных) и мужских (тычиночных) однополых цветков на одной и той де особи растения
Околоплодник : Оболочка плода растений, формируется стенками завязи
Околоцветник : Органы цветков, окружающие тычинки и пестик
Онтогенез : Индивидуальное развитие организма от зачатия до смерти
Оогамия : Тип полового процесса, при котором в оплодотворении участвуют яйцеклетка и сперматозоид
Оогенез : Образование женских половых клеток у растений
Оогоний : Женский половой орган
Органелла : Постоянный участок тела одноклеточной особи
Органогенез : Процесс формирования и развития органов в течение онтогенеза
Органоид : Обязательная структура цитоплазмы, выполняющая определенную функцию
Орнитология : Наука, изучающая птиц
Осморегуляция : Физико-химический процесс поддержания давления жидкости внутри тела
Палеолит : Древнейший период каменного века
Палеонтология : Наука, изучающая ископаемые организмы, условия их жизни
Параллелизм : Независимое приобретение организмами в ходе эволюции сходных черт строения на базе особенностей, унаследованных от общих предков
Паренхима : Основная ткань растений, состоящая из живых клеток, осуществляет ассимиляцию
Партеногенез : Развитие зародыша из неоплодотворенной яйцеклетки
Пелликула : Часть живой клетки, участвующая в обмене веществ
Перисперм : Запасающая диплоидная ткань семени растений, в которой откладываются питательные вещества
Пестик : Женский орган цветка, образованный одним или несколькими замкнутыми плодолистиками
Пестицид : Химическое соединение, используемое для защиты растений
Пигменты : Окрашенные вещества тканей организмов, от которых зависит окраска организмов
Пиноцитоз : Поглощение жидких веществ
Пирамида экологическая : Графическое изображение соотношения между продуцентами, консументами и редуцентами в экосистеме, которое выражается в единицах массы
Плазма : Жидкая или гелеобразная часть крови, лимфы
Пластида : Окрашенные пигментами или бесцветные цитоплазматические тельца клеток растений
Плацента : Орган связи зародыша с телом матери в период внутриутробного развития
Плодолистик : Спороносный лист в цветке, включающий семязачатки и при срастании краями образуют завязь пестика
Побег : Растительная ось, удлиненная или укороченная, нередко видоизмененная, и несущая листья и почки, стебли и листья побега возникают из меристемы (конуса нарастания)
Подвид : Географическая обособленная часть вида, особи в которой под влиянием факторов среды приобрели устойчивые особенности, отличающие ее от других частей того же вида
Пойкилотерм : Организм, не способный поддерживать внутреннюю температуру тела, а потому меняющий ее в зависимости от температуры среды
Полигамия : Многоженство – спаривание самца в период размножения со многими самками
Полимерия : Зависимость развития одного и того же признака или свойства организма от нескольких независимых по действию генов
Полиморфизм : Наличие в составе одного вида несколько четко морфологически отличающихся форм
Полиплоидия : Наследственное изменение, связанное с кратным увеличением основного числа хромосом в клетках организма
Полярность : Ориентация в пространстве морфологических процессов и структур у организмов, приводящая к возникновению морфологических различий на противоположных концах клеток
Популяция : Совокупность особей одного вида, имеющих общий генофонд и населяющих определенное пространство
Почкование : Бесполое размножение, при котором дочерние особи формируются из тканей материнского организма
Правило Э. Чаргаффа : В любых молекулах ДНК молярная сумма пуриновых оснований равна сумме пиримидиновых оснований
Прививка : Пересадка отрезка побега (черенка) или почки (глазка) одного растения (привоя) на другой (подвой)
Привой : Фрагмент одного растения, привитый на другое растение
Принцип Харди - Вайнберга : При отсутствии внешнего давления какого-либо фактора частоты генов в популяции стабилизируются в течение одной смены поколений
Продуцент : Организм – автотроф, производящий органические вещества из неорганических составляющих
Прокариоты : Организмы, не имеющие ядра
Протеид : Сложный белок, содержащий небелковый компонент – нуклеопротеиды
Протеин : Простой белок, состоящий только из остатков аминокислот
Протоплазма : Содержимое живой клетки, включая ядро и цитоплазму
Протопласт : Содержимое растительной клетки; состоит из клеточной мембраны, цитоплазмы и кариоплазмы, но не включает клеточную оболочку
Профаза : Первая фаза деления клетки и ее ядра
Пыльник : Часть тычинки, в которой образуется пыльца
Радиация адаптивная : Развитие в процессе эволюции различных видов из одного вида в различающихся условиях существования
Развитие параллельное : Возникновение в процессе эволюции от близких форм новых ветвей развития со сходными признаками
Развитие прямое : Развитие с постепенным ростом сформировавшегося зародыша без метаморфоза
Размножение бесполое : Возникновение двух или более новых особей в результате деления или почкования одноклеточных организмов
Размножение вегетативное : Развитие новой особи или части колонии из частицы материнской
Размножение половое : Развитие новой особи из зиготы, которая образуются при слиянии женских и мужских гамет
Регенерация : Восстановление организмом утраченных или поврежденных частей тела
Регресс биологический : Эволюционный упадок, упрощение систематической группы
Редукция : Уменьшение числа, размеров органов и тканей, упрощение их строения
Редупликация : Удвоение молекулы ДНК
Редуцент : Организм, превращающий органические вещества из неорганических (грибы и бактерии)
Резистентность : Устойчивость организма, невосприимчивость к каким - либо ядам
Резус–фактор : Антиген, содержащийся в эритроцитах
Рекомбинация : Появление новых сочетаний генов, ведущее к новым комбинациям признаков у потомства
Реликт : Биоценоз, занимающий небольшую площадь
Репродукция : Воспроизведение особей – размножение
Рефлекс : Ответная реакция организма на действие раздражителя
Рецептор : Специальное чувствительное образование, которые воспринимают и преобразуют раздражения из внешней или внутренней среды организмы
Рецессивность : Отсутствие фенотипического проявления одного аллеля у гетерозиготной особи
Рибоза : Моносахарид, присутствующий во всех живых клетках в составе РНК
Рибосома : Внутриклеточная частица, состоящая из РНК и белков, осуществляет биосинтез белка
Ризоиды : Нитевидные образования у мхов, заростков папоротников, лишайников, некоторых грибов и водорослей, выполняющие функцию корней
Ризосфера : Почва, окружающая корни растений, в которой большое количество микроорганизмов
РНК : Высокомолекулярное органическое соединение, образована нуклеотидами, в которые входят азотистые основания и рибоза
Рудимент : Недоразвитые органы, ткани и признаки, имевшиеся у предков, но утратившие значение в филогенезе
Рыльце (пестика) : Верхняя часть пестика в цветке
Сапробионт : Водный организм, живущий в водоеме, сильно загрязненном органическими веществами, с малым содержание кислорода
Сапротроф : Организмы, питающиеся падалью
Сапрофаг : Животные – санитары, питающиеся трупами, навозом
Сапрофит : Бактерия, гриб, растение, питающиеся за счет готового органического вещества и минеральных солей
Свертывание крови : Превращение жидкой крови в эластичный сгусток в результате перехода растворенного в ее плазме белка фибриногена в нерастворимый фибрин
Секреция : Процесс образования и выделения специальными железами активных веществ
Селекция : Выведение новых и улучшение существующих сортов растений, пород животных и штаммов микроорганизмов
Семядоли : Первые листья зародыша семенных растений
Семяпочка : Образование у семенных растений, из которого развивается семя
Сеть эндоплазматическая : Органоид, характерный для эукариот – совокупность сообщающихся друг с другом канальцев, вакуолей
Симбиоз : Тип взаимоотношений организмов разных организмов – совместное выгодное проживание 2-х особей
Симметрия билатеральная : Расположение частей тела, позволяющее разделить его на 2 равные половины лишь одной плоскостью
Симметрия лучистая : Расположение частей тела, позволяющее разделить его на 2 равные половины в нескольких плоскостях
Синантроп : Вид, обитающий вблизи человека
Синапс : Место соприкосновения нервных клеток друг с другом
Синус : Углубление, полость, выпячивание, длинный замкнутый канал
Синэкология : Раздел экологии, исследующий биотические сообщества и их взаимоотношения со средой обитания
Склеренхима : Механическая ткань стеблей и листьев растений, состоящая из волокон целлюлозы и склереид (каменистые клетки)
Слепота куриная : Не способность видеть в темноте
Соцветие : Часть растения, несущая цветок
Сперма : Жидкость, которая вырабатывается мужскими половыми железами, содержащая сперматозоиды
Спермагенез : Образование мужских половых клеток у низших растений в антеридиях, у высших растений – в пыльцевой трубке, у животных – в семеннике
Сперматофор : Склеенный пакет сперматозоидов
Сперматоцит : Мужская половая клетка в период роста и созревания
Спермий : У животных – сперматозоид; у голосеменных и покрытосеменных растений – мужская половая клетка
Спорангий : Орган, в котором образуются споры
Спорофилл : Видоизмененный лист хвощей, плаунов и высших растений, на котором развиты спорангии
Спорофит : Этап жизненного цикла растения от зиготы до образования спор
Стебель : Вегетативный орган высших растений, который являются осью побега
Стигма : Дыхальце – отверстие, которым открывается на поверхность тела орган дыхания (трахея) членистоногих животных
Строма : Любая опорная структура органов, тканей, клеток и внутриклеточных образований
Субстрат : Опорный компонент, одновременно и питательная среда
Суккулент : Растение с сочными мясистыми листьями (агава, алоэ) или стеблями
Сукцессия : Последовательная смена экосистем, возникающих на определенном участке земной поверхности
Сцепление генов : Связь между генами, которые расположены в одной хромосоме
Сыворотка : Жидкая часть крови без форменных элементов и фибрина, образующая в процессе их отделения при свертывании крови в организме
Таксис : Направленное перемещение организмов под влиянием односторонне действующего стимула: света (фототаксис), температуры (термотаксис), химических веществ (хемотаксис), влажности (гидротаксис), движения воды и воздуха – реотаксис
Таксон : Расположение в порядке
Телобласты : Две или несколько зародышевых клеток, на основе которых формируется мезодерма
Телофаза : Заключительная фаза деления клетки и ее ядра, в результате которой образуется две дочерние клетки
Термопериодизм : Реакция растений на периодическую смену повышенных и пониженных температур, выражающаяся в изменении процессов роста и развития
Терморегуляция : Способность организма обеспечивать постоянство температуры тела
Терморецептор : Чувствительное нервное окончание, реагирующее на изменения температуры
Терофит : Однолетнее растение, полностью отмирающее к зиме
Термофил : Организм, который не может жить в условиях пониженной температуры
Тимин : Пиримидиновое основание, содержащееся во всех организмах в составе ДНК
Ткань : Совокупность клеток, выполняющая определенную роль
Токсикоз : Явление общего отравления организма продуктами, образующимися в самом организме
Трансдукция : Пассивный перенос бактериальных генов из одной клетки в другую
Транскрипция : Биосинтез РНК на матрице ДНК – первый этап реализации генетической информации, в ходе которого последовательность нуклеотидов ДНК «переписывается» в нуклеотидную последовательность РНК
Трансляция : Синтез полипептидных цепей белков, идущий в клетках путем «считывания» генетической информации, «записанной» в виде последовательности нуклеотидов в молекулах и-РНК
Транспирация : Испарение воды растением
Трансфераза : Класс ферментов, катализирующих реакции переноса групп атомов от молекулы одного вещества (донора) на молекулу другого вещества
Трансформация : Изменение наследственных свойств клетки в результате проникновения или искусственного привнесения в нее чужеродной ДНК
Трансформизм : Представление об изменении и превращении форм организмов, происхождении одних из них
Тромбоцит : Форменный элемент крови, участвующий в свертывании крови
Тропизм : Направленное ростовое движение органов растений, вызванное односторонним действием раздражителя
Тургор : Упругость растительных клеток, тканей и органов вследствие давления содержимого клеток на их эластичные стенки
Тычинка : Мужской орган цветка, состоящий из тычиночной нити и пыльника
Фагоцит : Клетка многоклеточных животных, способная захватывать и переваривать посторонние тела
Фагоцитоз : Захват и поглощение живых клеток и неживых частиц
ФАД : Флавинадениндинуклеотид – кофермент, состоящий из соединенных в цепочку рибофлавина, рибита, 2 фосфорных групп, рибозы и аденина
Фанерофит : Растение, с которого почки возобновления, продолжающие рост после неблагоприятного времени года, находятся высоко над землей
Фауна : Животный мир земли
Фенотип : Совокупность всех внутренних и внешних признаков и свойств особи, сформировавшихся на базе генотипа в процессе онтогенеза
Фермент : Биологический катализатор – белок, регулирует метаболизм
Феромоны : Биологически активные вещества, вырабатываемые животными, оказывают влияние на поведение
Фибриллы : Тонкие волоконца, расположение внутри нервных клеток
Физиология : Наука, изучающая процессы, протекающие в организме
Филогенез : Историческое развитие организмов
Фитогормон : Физиологически активное вещество, образующееся в растениях и регулирующее их рост и развитие
Фитонцид : Вещество, убивающее микроорганизмы (содержится в луке, чесноке)
Фитофаг : Животное, питающееся только растительной пищей
Флора : Растительный мир земли
Флоэма : Ткань высших растений, которая проводит органические вещества из листьев во все части растения
Фотопериодизм : Реакции организмов на смену дня и ночи, которые проявляются в колебаниях интенсивности физиологических процессов
Фоторецепторы : Светочувствительные образования, способные поглощать свет и преобразовывать световое раздражение в нервный импульс
Фотосинтез : Поглощение углекислого газа и выделение кислорода, при котором образуется глюкоза
Фототроф : Фотосинтезирующий организм, т.е. использующий энергию света
Фотофил : Любой светолюбивый организм
Фотофоб : Тенелюбивый организм, не выносящий яркого света
Хамефит : Одна из жизненных форм растений, которая характеризуется расположением почек возобновления у поверхности почвы
Хеморецептор : Чувствительные нервные окончания, воспринимающие химические раздражения
Хемосинтез : Процесс образования некоторыми микроорганизмами органических веществ из двуокиси углерода за счет энергии, получаемой при окислении неорганических веществ
Хемотроф : Автотрофный организм, синтезирующий органические вещества за счет энергии окисления аммиака, сероводорода и других веществ, имеющихся в воде и почве
Хлоропласт : Пластид, придающий зеленый цвет растениям
Хророфилл : Зеленый пигмент растений, содержащийся в хлоропластах
Хоринон : Наружная оболочка зародышей высших животных
Хроматида : Одна из 2-х нуклеопротеидных нитей, образующихся при удвоении хромосом в процессе клеточного деления
Хроматофор : Крупный хлоропласт в клетке водорослей
Хромопласт : Пластид, придающий красный, оранжевый, желтый цвета растениям
Хромосома : Самовоспроизводящийся структурный элемент ядра клетки, содержащий ДНК, в которой заключена наследственная информация
Цветоложе : Осевая часть цветка, продолжение цветоножки или стебля, на котором расположен цветок
Цветоножка : Часть стебля, несущая цветок
Цветонос : Стебель, на котором расположены цветки
Целлюлоза : Углевод из группы полисахаридов, состоящий из остатков молекул глюкозы – главная часть клеточных стенок растений
Целом : Вторичная полость тела
Ценоз : Любое сообщество организмов
Центриоль : Клеточный органоид, две или большее парное число цилиндрических структур, образующих клеточный центр
Центромера : Участок хромосомы, удерживающий вместе 2 ее нити (хроматиды)
Цикл Кребса : Процесс полного окисления в организмах активированной уксусной кислоты, а также Ц.К. – завершающий этап распада углеводов, жиров и белков в организме животных
Циста : Форма существования одноклеточных организмов, временно покрывающихся плотной оболочкой, которая позволяет этим организмам пережить неблагоприятные условия среды
Цитозин : Пиримидиновое основание, содержится во всех организмах в составе нуклеиновых кислот
Цитокинез : Процесс образования 2 новых клеток из одной – деление цитоплазмы
Цитология : Наука, изучающая строение, химический состав, функции клеток
Цитоплазма : Внеядерная часть протоплазмы клеток живых организмов; состоит из гиалоплазмы, в которой содержатся органоиды и клеточные включения
Черенкование : Отделение от растения части его стебля, корня или листа, приживление этого фрагмента с последующим восстановлением недостающих органов целостного растения
Шизогония : Бесполое размножение путем разделения тела на большое количество дочерних особей
Шизонт : Фаза подготовки клетки к шизогонии у некоторых простейших
Штамб : Ствол дерева между корнем и кроной
Штамм : Чистая одновидовая культура микроорганизмов, выделенная из определенного источника и обладающая специфическими признаками
Щиток : 1) соцветие; 2) первый семядольный лист зародыша злаков, прилегающий к эндосперму; 3) часть спинной части среднегруди насекомого
Эволюция : Необратимое и направленное историческое развитие живой природы, при котором происходит изменение генетического состава популяций
Экология : Раздел биологии, изучающий взаимоотношения организмов и их сообществ с окружающей средой
Экосистема : Единый природный или природно-антропогенный комплекс, образованный живыми организмами и средой их обитания
Экотоп : Место обитания сообществ
Экскременты : Твердые и жидкие испражнения животных
Экскрет : Конечный продукт обмена веществ
Экскреция : Удаление из организма конечных продуктов обмена веществ
Эктодерма : Наружный зародышевый листок эмбриона многоклеточных животных
Эктопаразит : Организм, паразитирующий на поверхности тела хозяина (вши, блохи)
Эктоплазма : Внешний слой цитоплазмы клеток
Эмаль : Плотные выделения, покрывающие зубную коронку
Эмбриогенез : Процесс зародышевого развития организма
Эмбрион : Организм животного, в ранний период развития - от начала дробления яйца до выхода из яйцевых оболочек
Эндемик : Местный вид, обитающий только в данном регионе
Эндодерма : Внутренний слой первичной коры в стеблях и корнях растений, регулирует поступление веществ в проводящие ткани
Эндопаразит : Организм, паразитирующий внутри хозяина (гельминты)
Эндоплазма : Внутренний слой цитоплазмы клеток, содержащий клеточные включения
Эндосперм : Запасающая триплоидная ткань семян растений, в которой откладываются питательные вещества, необходимые для развития зародыша
Эндотелий : Слой уплощенных клеток, образующихся из мезенхимы и выстилающих изнутри стенки кровеносных и лимфатических сосудов
Энтодерма : Внутренний слой эмбриона многоклеточных организмов, из которого формируются печень, легкие и поджелудочная железа
Эпидермис : Поверхностный слой кожи позвоночных животных, состоящий из многослойного эпителия
Эпителий : Ткань, покрывающая поверхность кожи, роговицу глаза и выстилающая все полости организма
Эпифит : Растение, поселяющееся на других растениях
Эритроцит : Красное кровяное тельце – безъядерные клетки, содержащие гемоглобин
Эрозия : Поверхностное повреждение эпителиального покрова кожи или слизистой оболочки
Этология : Наука, раздел зоологии о поведении животных в естественных условиях
Эукариота : Высший организм, четко оформленное ядро которого обладает оболочкой
Яйцеклетка : Неподвижно женская половая клетка, из которой развивается организм в результате оплодотворения
Ярус : Часть слоя в сообществе растений
Абиогенез : Возникновение живого из неживого в процессе эволюции
Абиосфера : Слои атмосферы, не испытывающие и никогда не подвергавшиеся какому бы ни было влиянию живых организмов
Австралопитек : Прямоходящая, ископаемая человекообразная обезьяна
Автогамия : Самоопыление и самооплодотворение у цветковых растений
Автополиплоидия : Наследственное изменение, заключающееся в спонтанно возникающем кратном увеличении числа набора хромосом в клетках растений
Автотроф : Организм, получаемые органические соединения из неорганических с помощью энергии Солнца
Агглютинация : Склеивание и выпадение в осадок из однородной взвеси бактерий, эритроцитов и других клеток
Агроценоз : Сообщество, созданное человеком
Адаптация : Способность организмов, приспособиться к меняющимся условиям среды
Адвентивность : Приход вида из другого сообщества
Аденин : Пуриновое основание, содержащееся в составе нуклеиновых кислот
Аденозин : Нуклеотид, состоящий из пуринового основания аденина и моносахарида рибозы
Аденома : Доброкачественная опухоль молочной, щитовидной, предстательной желез
АДФ : Аденозиндифосфат - вещество, которое образуется в результате переноса концевой фосфатной группы
Азотобактерии : Группа аэробных свободноживущих бактерий, способных фиксировать азот из воздуха и тем самым обогащать им почву
Азотофиксация : Связывание молекулярного азота атмосферы и перевод его в органические азотистые основания – аминокислоты
Акклиматизация : Приспособление какого-либо вида к новым условиям существования
Аккомодация : Приспособление глаз к рассматриванию предметов
Аккумуляция : Накопление в организмах химических веществ
Акромегалия : Чрезмерный рост конечностей и костей лица вследствие нарушения функций гипофиза
Акселерация : Резкое убыстрение полового созревания, увеличение роста
Аксон : Отросток нервной клетки, проводящий нервные импульсы от тела клетки
Акцептор : Вещество, воспринимающее электроны и водород от окисляемых соединений и передающее их другим веществам
Аллель : Различные формы одного и того же гена, расположенные в одинаковых участках (локусах) гомологичных (парных) хромосом
Альбинизм : Врожденное отсутствие нормальной для данного вида организмов пигментации
Альвеола : Пузырьки в легких, на концах бронхов
Альгология : Наука о водорослях
Аминокислота : Органическое соединение, содержащее карбоксильную и аминогруппы
Амитоз : Прямое деление ядра клетки
Амниота : Высшее позвоночное животное (пресмыкающиеся, птицы, млекопитающие), приспособленное к развитию на суше
АМФ : Аденозинмонофосфат циклический – нуклеотид
Анабиоз : Временное состояние организма, при котором жизненные процессы замедленны
Анаболизм : Физиолого-биохимические процессы, составляющие част метаболизма и направленные усвоение клеткой пищевых веществ
Анализатор : Система нервных образований, осуществляющая восприятие и анализ раздражений
Аналогия : Сходство органов или их частей, разных по происхождению, но одинаковых по функции
Анатомия : Наука, изучающая строение и функции органов
Анаэроб : Организм, способный жить в бескислородной среде
Андроген : Группа мужских половых гормонов
Анемия : Малокровие – уменьшение количества эритроцитов
Антагонист : Мышцы и их группы, действующие одновременно или поочередно в 2 противоположных направлениях
Антеридий : Гаметофит - мужской половой орган размножения у грибов, водорослей мхов и папоротников
Антибиотик : Вещество, способное убивать микроорганизмы
Антиген : Сложное органическое вещество, способное при поступлении в организм животных и человека вызвать ответную иммунную реакцию – образование антител
Антикодон : Участок молекулы транспортной РНК, состоящий из 3 нуклеотидов
Антропоген : Последний из геологических периодов, в котором возрастало воздействие человека на природу
Антропогенез : Раздел антропологии – учение о происхождении человека
Антропология : Межотраслевая дисциплина, исследующая происхождение и эволюцию человека
Аппарат Гольджи : Органоид клетки, которых участвует в формировании некоторых продуктов жизнедеятельности
Ареал : Область распространения любой систематической группы организмов
Архегоний : Женский орган размножения у мхов, папоротников, хвощей, плаунов
Ассимиляция : Одна из сторон обмена веществ, потребление и превращение поступающих в организм веществ
Асфиксия : Удушье
Атавизм : Появление у отдельных особей каких-либо признаков, которые существовали у их далеких предков, но были утрачены в процессе эволюции (хвост, волосяной покров, многососковость)
Атрофия : Прижизненное уменьшение размеров органов и тканей
АТФ : Аденозинтрифосфат – нуклеотид, образованный аденозином и 3 остатками фосфорной кислоты
Аутбридинг : Скрещивание особей одного вида, не состоящих в непосредственном родстве
Аутосома : Хромосома, морфологически идентичная со своей гомологичной парой
Аутэкология : Раздел экологии, изучающий взаимоотношения отдельной особи с окружающей средой
Ахроматин : Вещество клеточного ядра, слабо окрашиваемое при гистологической обработке
Ацидоз : Накопление в крови и других тканях организма отрицательно заряженных ионов
Аэроб : Организмы, живущие только в кислородной среде
Аэробионт : Организм, живущий в воздушной среде
Бактериология : Раздел микробиологии, изучающий бактерии
Бактериостаз : Временное прекращение роста и размножения бактерий под воздействием различных факторов
Бактериофаг : Вирус бактерий, способный поражать бактериальную клетку
Бацилла : Бактерия, имеющая форму палочки
Белок : Высокомолекулярное органическое соединение, построенное из остатков 20 аминокислот
Бентос : Совокупность организмов, всю жизнь обитающих на дне океанов
Бивалент : Две гомологичные хромосомы, образующиеся при делении клеточного деления ядра
Биогенез : Процесс возникновения живого из живого
Биогеоценоз : Ограниченная природная система, в которой в тесной связи существуют живые организмы и окружающая среда
Биоиндикатор – виды или сообщества организмов, по наличию или состоянию которых можно судить о состоянии окружающей среды. : 
Биолокация : Способность животного определять свое положение
Биолюминесценция : Видимое свечение организмов, связанное с процессами их жизнедеятельности
Биом : Совокупность видов животных и растений, составляющих живое население
Биомасса : Выраженное в единицах массы или энергии количество живого вещества тех или иных организмов, приходящееся на единицу площади
Биополимеры : Высокомолекулярные природные соединения – белки, нуклеиновые кислоты, полисахариды, служащие структурными частями живых организмов
Биосинтез : Процесс образования необходимых организму веществ, протекающий в его клетках с участием биокатализаторов – ферментов
Биотоп : Относительно однородное по абиотическим факторам среды пространство в пределах водной, наземной и подземной частей биосферы
Биоценоз : Взаимосвязанная совокупность микроорганизмов, растений, грибов и животных, населяющих однородный участок суши или водоема
Бластомеры : Очень крупные, однотипные клетки дробящегося яйца животного
Бластопор : Отверстие, посредством которого полость двухслойного зародыша животных (гаструла) с внешней средой
Бластоцель : Первичная полость тела животного на стадии бластулы
Бластула : Фаза зародышевого развития многоклеточных животных
Бриология : Наука, изучающая мхи
Вакуоль : Полость в протоплазме клетки, заполненная клеточным соком (кариоплазма)
Вакцина : Препарат из живых ослабленных микроорганизмов, применяемый для иммунизации человека или животных в лечебных целях
Вегетация : Произрастание, состояние активной жизнедеятельности растения, рост и питание
Везикула : Образование в теле организма, имеющее вид пузырька
Венчик : Внутренняя часть отдельных или сросшихся между собой лепестков двойного околоцветника
Вирус : Неклеточная форма жизни, способная проникать в живую клетку и размножаться только внутри ее
Вирусология : Наука, изучающая вирусы
Витализм : Совокупность идеалистических течений в биологии, объясняющих жизненные явления действием «жизненной силы»
Витамин : Органическое вещество, образующееся в животном организме или поступающееся в пищу для нормального функционирования
Вторичноротые : Группа животных – иглокожие, хордовые – при эмбриональном развитии рот образуется на противоположной стороне зародыша
Галлофил : Организмы, живущие с повышенным процентом соли
Галофит : Растение, обитающее на засоленных почвах и горных породах
Галлофоб : Организм, не выносящий повышенной солености среды
Гамета : Половые клетки с гаплоидным набором хромосом
Гаметангий : Половой орган, в котором образуются гаметы
Гаметогенез : Процесс образования гамет
Гаметогония : Половое размножение у простейших
Гаметофит : Представитель полового поколения или этап жизненного цикла растений от споры до зиготы
Гаметоцит : Незрелые половые клетки у простейших
Гаплоид : Клетка или особь с одинарным набором непарных хромосом
Гастроцель : Полость зародыша на стадии гаструлы
Гаструла : Фаза зародышевого развития многоклеточных животных – двухслойный мешок
Гаструляция : Процесс образования гаструлы
Гельминтоз : Заболевание организма, вызванное паразитическими червями
Гельминтология : Отрасль зоологии, исследующая паразитических червей
Гемоглобин : Красный дыхательный пигмент крови человека и животных
Гемолимфа : Жидкость, циркулирующая в незамкнутой кровеносной системе
Гемофилия : Наследственное заболевание, характеризуемое повышенной кровоточивостью, что объясняется недостатком факторов свертывания крови
Гемоцит : Любой клеточный элемент крови
Ген : Единица наследственного материала, участок молекулы ДНК
Генерация : Разовое потомство одной особи, группы или популяции
Генетика : Наука, изучающая законы наследственности и изменчивости
Геном : Совокупность генов, содержащихся в гаплоидном наборе хромосом
Генотип : Совокупность всех наследственных свойств особи
Генофонд : Совокупность генов группы особей популяции
Геофит : Многолетнее растение, почки возобновления которого находятся в подземных органах
Гербицид : Вещество, используемое для избирательного уничтожения нежелательных растений
Гермафродитизм : Наличие признаков мужского и женского пола у одной особи животного
Герпетология : Раздел зоологии, изучающий земноводных и пресмыкающихся
Гетерогамия : Тип полового процесса, при котором сливающиеся гаметы различаются по внешнему виду
Гетерогенез : Смена способов размножения у организмов на протяжении двух или более поколений
Гетерозигота : Содержание в клетках тела разных генов данной аллельной пары
Гетерозис : Ускорение роста, увеличение размеров
Гетеротроф : Организм, использующий для питания только органические вещества
Гиалоплазма : Коллоидная система, в которой расположены ядро и все органоиды
Гигрофил : Щрганизм, приспособленный к обитанию в условиях высокой влажности
Гигрофит : Наземные растения, приспособленные к обитанию в условиях избыточной влажности
Гигрофоб : Наземные животные, избегающие избыточной влажности
Гидробионт : Организм, постоянно обитающий в водной среде
Гидрофил : Организм, любящий воду
Гидрофит : Водные растения, погруженные в воду только нижними частями
Гидрофоб : Организм, избегающий воды
Гинецей : Совокупность пестиков в цветке
Гипертрофия : Чрезмерное увеличение объема органов или части тела вследствие увеличения размеров и числа клеток
Гиподерма : Слой эпителия у беспозвоночных животных, расположенный под кутикулой
Гиподинамия : Нарушение функций организма при малой двигательной активности
Гипотония : Пониженное кровяное давление
Гистология : Наука, изучающая ткани
Гиф : Одноклеточная или многоклеточная нить, образующая вегетативное и плодовое тело (мицелий и таллом) гриба
Гликокаликс : Наружный слой клетки животного организма
Гликолиз : Процесс расщепления углеводов без кислорода под действием ферментов
Гомеостаз : Состояние динамичного подвижного равновесия природной системы
Гомогамия : Одновременное созревание на одном и том же обоеполом растение мужских и женских органов, способствующее самоопылению
Гомозигота : Содержание клеткой одинаковых генов данной аллельной пары
Гомойотерм : Организм с постоянной температурой тела, которая не зависит от окружающей среды
Гомология : Сходство органов или их частей одинакового происхождения
Гормон : Биологическое активное вещество, вырабатываемое железами внутренней секреции
Гуанин : Пуриновое основание, содержащееся в клетках организмов в составе нуклеиновых кислот
Дальтонизм : Наследственная неспособность различать некоторые цвета
Двудомность : Образование женских и мужских половых органов на разных экземпляров растений одного вида
Дегенерация : Вырождение, ухудшение из поколения в поколение биологических свойств организма в результате неблагоприятных условий организма
Дезоксирибоза : Простой углевод (моносахарид)
Демэкология : Раздел экологии, исследующий взаимоотношение популяций с окружающей средой
Дерма : Нижний слой кожи мезодермального происхождения
Деструктор : Организм, разрушающий что-либо
Диакинез : Заключительная стадия профазы мейоза, во время которой хромосомы максимально укорачиваются в ходе спирализации
Дивергенция : Расхождение признаков у родственных организмов
Диплоид : Особь или клетка с 2 гомологичными наборами хромосом
Диссимиляция : Процесс разрушения органических веществ на более простые
Дифференциация : Разделение таксона на 2 или несколько частей
Доминант : Вид, преобладающий в сообществе
Донор : Организм, у которого берут часть для пересадки другому организму (акцептору)
Дрейф генов : Изменение генетической структуры популяции в результате любых случайных причин
Дупликация : Разновидность хромосомных перестроек
Железа экзокринная : Железа, имеющая выводящие протоки и выделяющая вырабатываемые ею секреты на поверхность тела
Железа эндокринная : Железа, не имеющая выводных протоков и выделяющая вырабатываемые ею вещества непосредственно в кровь
Завязь : Нижняя расширенная часть пестика, из которой образуется плод
Закон биогенетический : Онтогенез есть краткое и быстрое повторение филогенеза
Закон биогенной миграции атомов В.И. Вернадского : Миграция химических элементов на земной поверхности и в биосфере в целом осуществляется или при непосредственном участии живого вещества, или же она протекает в среде, геохимические особенности которой обусловлены живым веществом
Закон гомологических рядов наследственной изменчивости Н.И. Вавилова : Виды и роды, генетически близкие, характеризуются сходными рядами наследственной изменчивости с такой правильностью, что, зная ряд форм в пределах одного вида, можно предвидеть нахождение параллельных форм у других видов и родов. Чем ближе генетически расположены в общей системе роды, тем полнее сходство в рядах их изменчивости
Закон единообразия гибридов первого поколения : Первое поколение гибридов, в силу проявления у них лишь доминантных признаков
Закон зародышевого сходства : На ранних стадиях эмбрионального развития организмы сходны с соответствующими стадиями развития предковых и родственных форм
Закон независимого комбинирования признаков : Гены одной аллельной пары распределяются в мейозе независимо от генов других пар и комбинируются в процессе образования гамет случайно, что ведет к разнообразию вариантов их соединений
Закон расщепления гибридов второго поколения : Во втором поколении гибридов соотношение особей с доминантными и рецессивными признаками равно 3:1
Закон чистоты гамет Г. Менделя : Гамета диплоидного гибрида может нести лишь один из двух аллелей данного гена
Замор : Массовая гибель водных организмов
Заросток : Половое поколение (гаметофит) низших споровых растений
Зигота : Оплодотворенное яйцо, диплоидная клетка, образованная в результате слияния гамет
Зооспора : Подвижная клетка водорослей и некоторых грибов, служащая для бесполого размножения
Зоохор : Растение и гриб, зачатки, которых распространяются животными
Идиоадаптация : Совершенствование организмов путем частных изменений в строении органов
Изоляция : Разобщение особей друг от друга
Изомеразы : Класс ферментов, катализирующих в клетках внутримолекулярные перестройки
Имаго : Взрослая особь насекомых
Иммиграция : Вселение в какую-либо местность организмов, ранее здесь не обитавших
Иммунитет : Сопротивляемость организма к инфекционным заболеваниям
Имплантация : Внедрение зародыша высших млекопитающих в слизистую оболочку матки
Инбридинг : Близкородственное скрещивание
Ингибитор : Вещество, замедляющее протекание химических процессов
Инкубация : Время развития зародыша в яйце птицы искусственным путем
Инсайт : Элементы разумной деятельности у животных
Интеграция : Процесс соединения в раннем онтогенезе клеток генетически одинакового типа в скопления и их распределения в определенном порядке
Интерфаза : Состояние клетки между ее делением
Интерферон : Защитный белок, вырабатываемый клетками млекопитающих и птиц в ответ на заражение вирусами
Интоксикация : Отравление организма
Интродукция : Преднамеренный или случайный перенос особей какого-либо вида живого за пределы его ареала
Информосома : Внутриклеточная частица эукариот, участвующая в биосинтезе белка, состоит из РНК
Ихтиология : Раздел зоологии, изучающий рыб
Кадастр : Систематизированный свод данных, включающий качественную и количественную опись объектов или явлений
Камбий : Однорядный слой клеток образовательной ткани в стеблях и корнях двудольных и голосеменных растений
Каннибализм : Форма взаимоотношения особей одного вида, которая заключается в поедании друг друга
Канцероген : Вещество, способное вызвать злокачественное новообразование
Капилляр : Тончайший кровеносный сосуд, соединяющий артериальную и венозную системы
Капсула : Оболочка, прикрывающая органы или их части
Кариотип : Диплоидный набор хромосом в соматических клетках организма
Каротиноиды : Пигменты красного, желтого и оранжевого цвета, которые встречаются в растительных и некоторых животных тканях
Катаболизм : Биохимические процессы, направленные на распад пищевых веществ
Катагенез : Упрощение организации и образа жизни организма в результате приспособления к более стабильным условиям существования
Каталаза : Фермент, катализирующий процесс разложения токсичной перекиси водорода
Катализатор : Вещество, ускоряющее химические процессы
Кифоз : Изгиб позвоночника выпуклостью назад
Коадаптация : Взаимное приспособление в ходе эволюции
Коацерваты : Живые белковые сгустки
Колленхима : Механическая ткань из живых клеток с пластичными водосодержащими оболочками
Комменсализм : Постоянное или временное сожительство особей разных видов, извлекая одностороннюю пользу без вреда для другого
Конвергенция : Появление сходных признаков у разных организмов
Консумент : Организмы, потребляющие готовые органические вещества
Конъюгация : Обмен генетическим материалом у простейших
Копрофаг : Животное, питающееся экскрементами
Кофермент : Сложное органическое вещество небелковой природы
Креационизм : Теория божественного сотворения мира
Криофил : Организм, способный жить в условиях низкой температуры
Криофит : Растение сухих и холодных местообитаний
Кроссинговер : Обмен равными участками гомологичных хромосом
Ксантофиллы : Группа желтых красящихся пигментов, содержащихся в частях растения
Ксерофил : Организмы, способные жить в сухих местах
Ксерофит : Растение засушливых местообитаний
Ксилема : Ткань высших растений, проводит воду от корней к листьям
Кутикула : Плотная мертвая оболочка на поверхности клеток
Латентный период : Время от момента воздействия на организм какого-либо раздражителя до появления видимой ответной реакции
Латеральный : Расположение органа или части тела сбоку от оси организма
Лейкопласты : Бесцветные пластиды, встречающиеся в корневищах, клубнях
Лейкоциты : Бесцветные, подвижные клетки животных, способные захватывать и переваривать микроорганизмы
Летальный : Смертельный исход
Летаргия : Болезненный сон, длящийся от нескольких часов до нескольких часов
Лигаза : Фермент, катализирующий в клетках присоединение друг к другу двух различных молекул
Лигнин : Органическое полимерное соединение, которое содержится в клеточных оболочках сосудистых растений
Лизосома : Клеточный органоид, участвующий в переваривании белков
Лимфа : Бесцветная жидкость, которая образуется из плазмы крови
Лимфоцит : Одна из форм незернистых лейкоцитов, которая образуется в лимфатических узлах
Липид : Жироподобное вещество
Локус : Участок хромосомы, в котором локализован ген
Макронуклеус : Крупное ядро у инфузорий
Макроспора : Крупная спора, из которой развивается женский заросток (гаметофит)
Макроспорангий : Орган, в котором у споровых и семенных растений развиваются женские заростки
Макрофаг : Клетка, способная к захватыванию и перевариванию посторонних частичек. Открыл Мечников
Макрофит : Растение-макроорганизм
Макроэволюция : Процесс образования крупных таксонов
Медиатор : Вещество, молекулы которого способны реагировать со специфическими рецепторами клеточной мембраны и изменять ее проницаемость
Междоузлие : Участок стебля растения между точками прикрепления листьев
Межклетник : Полость между клетками в теле растения
Мезенхима : Соединительная ткань, возникает за счет клеток, которые выселяются из разных зародышевых листков: энто-, эндо- и мезодермы
Мезоглея : Студенистое вещество, залегающее между экто- и эндодермой у губок и кишечнополостных
Мезодерма : Серединный зародышевый листок
Мезотелий : Эпителиальная ткань, выстилающая серозные оболочки полостей тела
Мезофилл : Мякоть или основная часть листка растений
Мезофит : Растение, обитающее в условиях более или менее достаточного, но не избыточного увлажнения
Мейоз : Процесс деления гамет, в результате которого происходит уменьшение (редукция) числа хромосом
Меланизм : Явление темной окраски животных, зависящий от наличия в их покровах черных и темно-коричневых пигментов
Метаболизм : Обмен веществ
Метаморфоз : Процесс превращения ювенильных фаз развития во взрослое животное
Метафаза : Вторая стадия деления ядра
Механорецептор : Чувствительное нервное окончание, воспринимающее раздражения
Микология : Наука, изучающая грибы
Микориза : Симбиотическое обитание грибов на корнях деревьев
Микробиология : Наука, изучающая микроорганизмы
Микронуклеус : Меньшее из ядер инфузорий
Микроспора : Мелкая спора, из которой развивается мужской заросток
Микрофаг : Одна из форм лейкоцитов, способных к фагоцитозу мелких инородных частиц, в т.ч. микробов
Микрофил : Организм, выносящий только очень небольшие колебания температуры
Микрофлора : Флора микроорганизмов в сообществе
Микроэфолюция : Процесс образования популяций и подвидов
Мимикрия : Подражательность, имитирование
Миоцен : Нижнее подразделение неогенового периода
Митоз : Непрямое деление ядра клетки, в результате увеличивается число клеток
Митохондрия : Энергетическая станция клетки
Мицелий : Вегетативное тело гриба, состоящее из нитей – гифов
Многодомность : Образование двуполых и однополых цветков на одной особи растений
Модификация : Ненаследственное изменение признаков организма, возникающее под воздействием изменившихся условий окружающей его среды
Моногамия : Единобрачие, спаривание самца с одной самкой в течение одного или нескольких сезонов
Монокарпия : Растение, плодоносящее и цветущее один раз
Мутаген : Любой фактор, вызывающий мутацию
Мутагенез : Процесс возникновения мутаций
Мутация : Изменение наследственных свойств организма
Мутуализм : Форма симбиоза, при которой каждый из сожителей получает относительную равную пользу
Нейрула : Стадия развития зародыша хордовых, в которой происходит закладка из эктодермы пластинки нервной трубки
Некрофаг : Организм, питающийся мертвыми животными
Неолит : Новый каменный век
Неофит : Недавно появившийся в местной флоре вид, например сорняк
Нерест : Выметание рабами яйц
Нимфа : Последняя личиночная фаза постэмбрионального развития членистоногих, развивающихся с неполным метаморфозом
Нить ахроматиновая : Микротрубочка, входящая в состав ахроматинового веретена
Нуклеазы : Ферменты, расщепляющие нуклеиновые кислоты в живых организмах
Нуклеотид : Фосфорный эфир нуклеозида, состоящий из азотистого основания, углевода и остатка фосфорной кислоты
Овуляция : Выход яйцеклеток из яичника в полость тела
Однодомность : Образование женских (пестичных) и мужских (тычиночных) однополых цветков на одной и той де особи растения
Околоплодник : Оболочка плода растений, формируется стенками завязи
Околоцветник : Органы цветков, окружающие тычинки и пестик
Онтогенез : Индивидуальное развитие организма от зачатия до смерти
Оогамия : Тип полового процесса, при котором в оплодотворении участвуют яйцеклетка и сперматозоид
Оогенез : Образование женских половых клеток у растений
Оогоний : Женский половой орган
Органелла : Постоянный участок тела одноклеточной особи
Органогенез : Процесс формирования и развития органов в течение онтогенеза
Органоид : Обязательная структура цитоплазмы, выполняющая определенную функцию
Орнитология : Наука, изучающая птиц
Осморегуляция : Физико-химический процесс поддержания давления жидкости внутри тела
Палеолит : Древнейший период каменного века
Палеонтология : Наука, изучающая ископаемые организмы, условия их жизни
Параллелизм : Независимое приобретение организмами в ходе эволюции сходных черт строения на базе особенностей, унаследованных от общих предков
Паренхима : Основная ткань растений, состоящая из живых клеток, осуществляет ассимиляцию
Партеногенез : Развитие зародыша из неоплодотворенной яйцеклетки
Пелликула : Часть живой клетки, участвующая в обмене веществ
Перисперм : Запасающая диплоидная ткань семени растений, в которой откладываются питательные вещества
Пестик : Женский орган цветка, образованный одним или несколькими замкнутыми плодолистиками
Пестицид : Химическое соединение, используемое для защиты растений
Пигменты : Окрашенные вещества тканей организмов, от которых зависит окраска организмов
Пиноцитоз : Поглощение жидких веществ
Пирамида экологическая : Графическое изображение соотношения между продуцентами, консументами и редуцентами в экосистеме, которое выражается в единицах массы
Плазма : Жидкая или гелеобразная часть крови, лимфы
Пластида : Окрашенные пигментами или бесцветные цитоплазматические тельца клеток растений
Плацента : Орган связи зародыша с телом матери в период внутриутробного развития
Плодолистик : Спороносный лист в цветке, включающий семязачатки и при срастании краями образуют завязь пестика
Побег : Растительная ось, удлиненная или укороченная, нередко видоизмененная, и несущая листья и почки, стебли и листья побега возникают из меристемы (конуса нарастания)
Подвид : Географическая обособленная часть вида, особи в которой под влиянием факторов среды приобрели устойчивые особенности, отличающие ее от других частей того же вида
Пойкилотерм : Организм, не способный поддерживать внутреннюю температуру тела, а потому меняющий ее в зависимости от температуры среды
Полигамия : Многоженство – спаривание самца в период размножения со многими самками
Полимерия : Зависимость развития одного и того же признака или свойства организма от нескольких независимых по действию генов
Полиморфизм : Наличие в составе одного вида несколько четко морфологически отличающихся форм
Полиплоидия : Наследственное изменение, связанное с кратным увеличением основного числа хромосом в клетках организма
Полярность : Ориентация в пространстве морфологических процессов и структур у организмов, приводящая к возникновению морфологических различий на противоположных концах клеток
Популяция : Совокупность особей одного вида, имеющих общий генофонд и населяющих определенное пространство
Почкование : Бесполое размножение, при котором дочерние особи формируются из тканей материнского организма
Правило Э. Чаргаффа : В любых молекулах ДНК молярная сумма пуриновых оснований равна сумме пиримидиновых оснований
Прививка : Пересадка отрезка побега (черенка) или почки (глазка) одного растения (привоя) на другой (подвой)
Привой : Фрагмент одного растения, привитый на другое растение
Принцип Харди - Вайнберга : При отсутствии внешнего давления какого-либо фактора частоты генов в популяции стабилизируются в течение одной смены поколений
Продуцент : Организм – автотроф, производящий органические вещества из неорганических составляющих
Прокариоты : Организмы, не имеющие ядра
Протеид : Сложный белок, содержащий небелковый компонент – нуклеопротеиды
Протеин : Простой белок, состоящий только из остатков аминокислот
Протоплазма : Содержимое живой клетки, включая ядро и цитоплазму
Протопласт : Содержимое растительной клетки; состоит из клеточной мембраны, цитоплазмы и кариоплазмы, но не включает клеточную оболочку
Профаза : Первая фаза деления клетки и ее ядра
Пыльник : Часть тычинки, в которой образуется пыльца
Радиация адаптивная : Развитие в процессе эволюции различных видов из одного вида в различающихся условиях существования
Развитие параллельное : Возникновение в процессе эволюции от близких форм новых ветвей развития со сходными признаками
Развитие прямое : Развитие с постепенным ростом сформировавшегося зародыша без метаморфоза
Размножение бесполое : Возникновение двух или более новых особей в результате деления или почкования одноклеточных организмов
Размножение вегетативное : Развитие новой особи или части колонии из частицы материнской
Размножение половое : Развитие новой особи из зиготы, которая образуются при слиянии женских и мужских гамет
Регенерация : Восстановление организмом утраченных или поврежденных частей тела
Регресс биологический : Эволюционный упадок, упрощение систематической группы
Редукция : Уменьшение числа, размеров органов и тканей, упрощение их строения
Редупликация : Удвоение молекулы ДНК
Редуцент : Организм, превращающий органические вещества из неорганических (грибы и бактерии)
Резистентность : Устойчивость организма, невосприимчивость к каким - либо ядам
Резус–фактор : Антиген, содержащийся в эритроцитах
Рекомбинация : Появление новых сочетаний генов, ведущее к новым комбинациям признаков у потомства
Реликт : Биоценоз, занимающий небольшую площадь
Репродукция : Воспроизведение особей – размножение
Рефлекс : Ответная реакция организма на действие раздражителя
Рецептор : Специальное чувствительное образование, которые воспринимают и преобразуют раздражения из внешней или внутренней среды организмы
Рецессивность : Отсутствие фенотипического проявления одного аллеля у гетерозиготной особи
Рибоза : Моносахарид, присутствующий во всех живых клетках в составе РНК
Рибосома : Внутриклеточная частица, состоящая из РНК и белков, осуществляет биосинтез белка
Ризоиды : Нитевидные образования у мхов, заростков папоротников, лишайников, некоторых грибов и водорослей, выполняющие функцию корней
Ризосфера : Почва, окружающая корни растений, в которой большое количество микроорганизмов
РНК : Высокомолекулярное органическое соединение, образована нуклеотидами, в которые входят азотистые основания и рибоза
Рудимент : Недоразвитые органы, ткани и признаки, имевшиеся у предков, но утратившие значение в филогенезе
Рыльце (пестика) : Верхняя часть пестика в цветке
Сапробионт : Водный организм, живущий в водоеме, сильно загрязненном органическими веществами, с малым содержание кислорода
Сапротроф : Организмы, питающиеся падалью
Сапрофаг : Животные – санитары, питающиеся трупами, навозом
Сапрофит : Бактерия, гриб, растение, питающиеся за счет готового органического вещества и минеральных солей
Свертывание крови : Превращение жидкой крови в эластичный сгусток в результате перехода растворенного в ее плазме белка фибриногена в нерастворимый фибрин
Секреция : Процесс образования и выделения специальными железами активных веществ
Селекция : Выведение новых и улучшение существующих сортов растений, пород животных и штаммов микроорганизмов
Семядоли : Первые листья зародыша семенных растений
Семяпочка : Образование у семенных растений, из которого развивается семя
Сеть эндоплазматическая : Органоид, характерный для эукариот – совокупность сообщающихся друг с другом канальцев, вакуолей
Симбиоз : Тип взаимоотношений организмов разных организмов – совместное выгодное проживание 2-х особей
Симметрия билатеральная : Расположение частей тела, позволяющее разделить его на 2 равные половины лишь одной плоскостью
Симметрия лучистая : Расположение частей тела, позволяющее разделить его на 2 равные половины в нескольких плоскостях
Синантроп : Вид, обитающий вблизи человека
Синапс : Место соприкосновения нервных клеток друг с другом
Синус : Углубление, полость, выпячивание, длинный замкнутый канал
Синэкология : Раздел экологии, исследующий биотические сообщества и их взаимоотношения со средой обитания
Склеренхима : Механическая ткань стеблей и листьев растений, состоящая из волокон целлюлозы и склереид (каменистые клетки)
Слепота куриная : Не способность видеть в темноте
Соцветие : Часть растения, несущая цветок
Сперма : Жидкость, которая вырабатывается мужскими половыми железами, содержащая сперматозоиды
Спермагенез : Образование мужских половых клеток у низших растений в антеридиях, у высших растений – в пыльцевой трубке, у животных – в семеннике
Сперматофор : Склеенный пакет сперматозоидов
Сперматоцит : Мужская половая клетка в период роста и созревания
Спермий : У животных – сперматозоид; у голосеменных и покрытосеменных растений – мужская половая клетка
Спорангий : Орган, в котором образуются споры
Спорофилл : Видоизмененный лист хвощей, плаунов и высших растений, на котором развиты спорангии
Спорофит : Этап жизненного цикла растения от зиготы до образования спор
Стебель : Вегетативный орган высших растений, который являются осью побега
Стигма : Дыхальце – отверстие, которым открывается на поверхность тела орган дыхания (трахея) членистоногих животных
Строма : Любая опорная структура органов, тканей, клеток и внутриклеточных образований
Субстрат : Опорный компонент, одновременно и питательная среда
Суккулент : Растение с сочными мясистыми листьями (агава, алоэ) или стеблями
Сукцессия : Последовательная смена экосистем, возникающих на определенном участке земной поверхности
Сцепление генов : Связь между генами, которые расположены в одной хромосоме
Сыворотка : Жидкая часть крови без форменных элементов и фибрина, образующая в процессе их отделения при свертывании крови в организме
Таксис : Направленное перемещение организмов под влиянием односторонне действующего стимула: света (фототаксис), температуры (термотаксис), химических веществ (хемотаксис), влажности (гидротаксис), движения воды и воздуха – реотаксис
Таксон : Расположение в порядке
Телобласты : Две или несколько зародышевых клеток, на основе которых формируется мезодерма
Телофаза : Заключительная фаза деления клетки и ее ядра, в результате которой образуется две дочерние клетки
Термопериодизм : Реакция растений на периодическую смену повышенных и пониженных температур, выражающаяся в изменении процессов роста и развития
Терморегуляция : Способность организма обеспечивать постоянство температуры тела
Терморецептор : Чувствительное нервное окончание, реагирующее на изменения температуры
Терофит : Однолетнее растение, полностью отмирающее к зиме
Термофил : Организм, который не может жить в условиях пониженной температуры
Тимин : Пиримидиновое основание, содержащееся во всех организмах в составе ДНК
Ткань : Совокупность клеток, выполняющая определенную роль
Токсикоз : Явление общего отравления организма продуктами, образующимися в самом организме
Трансдукция : Пассивный перенос бактериальных генов из одной клетки в другую
Транскрипция : Биосинтез РНК на матрице ДНК – первый этап реализации генетической информации, в ходе которого последовательность нуклеотидов ДНК «переписывается» в нуклеотидную последовательность РНК
Трансляция : Синтез полипептидных цепей белков, идущий в клетках путем «считывания» генетической информации, «записанной» в виде последовательности нуклеотидов в молекулах и-РНК
Транспирация : Испарение воды растением
Трансфераза : Класс ферментов, катализирующих реакции переноса групп атомов от молекулы одного вещества (донора) на молекулу другого вещества
Трансформация : Изменение наследственных свойств клетки в результате проникновения или искусственного привнесения в нее чужеродной ДНК
Трансформизм : Представление об изменении и превращении форм организмов, происхождении одних из них
Тромбоцит : Форменный элемент крови, участвующий в свертывании крови
Тропизм : Направленное ростовое движение органов растений, вызванное односторонним действием раздражителя
Тургор : Упругость растительных клеток, тканей и органов вследствие давления содержимого клеток на их эластичные стенки
Тычинка : Мужской орган цветка, состоящий из тычиночной нити и пыльника
Фагоцит : Клетка многоклеточных животных, способная захватывать и переваривать посторонние тела
Фагоцитоз : Захват и поглощение живых клеток и неживых частиц
ФАД : Флавинадениндинуклеотид – кофермент, состоящий из соединенных в цепочку рибофлавина, рибита, 2 фосфорных групп, рибозы и аденина
Фанерофит : Растение, с которого почки возобновления, продолжающие рост после неблагоприятного времени года, находятся высоко над землей
Фауна : Животный мир земли
Фенотип : Совокупность всех внутренних и внешних признаков и свойств особи, сформировавшихся на базе генотипа в процессе онтогенеза
Фермент : Биологический катализатор – белок, регулирует метаболизм
Феромоны : Биологически активные вещества, вырабатываемые животными, оказывают влияние на поведение
Фибриллы : Тонкие волоконца, расположение внутри нервных клеток
Физиология : Наука, изучающая процессы, протекающие в организме
Филогенез : Историческое развитие организмов
Фитогормон : Физиологически активное вещество, образующееся в растениях и регулирующее их рост и развитие
Фитонцид : Вещество, убивающее микроорганизмы (содержится в луке, чесноке)
Фитофаг : Животное, питающееся только растительной пищей
Флора : Растительный мир земли
Флоэма : Ткань высших растений, которая проводит органические вещества из листьев во все части растения
Фотопериодизм : Реакции организмов на смену дня и ночи, которые проявляются в колебаниях интенсивности физиологических процессов
Фоторецепторы : Светочувствительные образования, способные поглощать свет и преобразовывать световое раздражение в нервный импульс
Фотосинтез : Поглощение углекислого газа и выделение кислорода, при котором образуется глюкоза
Фототроф : Фотосинтезирующий организм, т.е. использующий энергию света
Фотофил : Любой светолюбивый организм
Фотофоб : Тенелюбивый организм, не выносящий яркого света
Хамефит : Одна из жизненных форм растений, которая характеризуется расположением почек возобновления у поверхности почвы
Хеморецептор : Чувствительные нервные окончания, воспринимающие химические раздражения
Хемосинтез : Процесс образования некоторыми микроорганизмами органических веществ из двуокиси углерода за счет энергии, получаемой при окислении неорганических веществ
Хемотроф : Автотрофный организм, синтезирующий органические вещества за счет энергии окисления аммиака, сероводорода и других веществ, имеющихся в воде и почве
Хлоропласт : Пластид, придающий зеленый цвет растениям
Хророфилл : Зеленый пигмент растений, содержащийся в хлоропластах
Хоринон : Наружная оболочка зародышей высших животных
Хроматида : Одна из 2-х нуклеопротеидных нитей, образующихся при удвоении хромосом в процессе клеточного деления
Хроматофор : Крупный хлоропласт в клетке водорослей
Хромопласт : Пластид, придающий красный, оранжевый, желтый цвета растениям
Хромосома : Самовоспроизводящийся структурный элемент ядра клетки, содержащий ДНК, в которой заключена наследственная информация
Цветоложе : Осевая часть цветка, продолжение цветоножки или стебля, на котором расположен цветок
Цветоножка : Часть стебля, несущая цветок
Цветонос : Стебель, на котором расположены цветки
Целлюлоза : Углевод из группы полисахаридов, состоящий из остатков молекул глюкозы – главная часть клеточных стенок растений
Целом : Вторичная полость тела
Ценоз : Любое сообщество организмов
Центриоль : Клеточный органоид, две или большее парное число цилиндрических структур, образующих клеточный центр
Центромера : Участок хромосомы, удерживающий вместе 2 ее нити (хроматиды)
Цикл Кребса : Процесс полного окисления в организмах активированной уксусной кислоты, а также Ц.К. – завершающий этап распада углеводов, жиров и белков в организме животных
Циста : Форма существования одноклеточных организмов, временно покрывающихся плотной оболочкой, которая позволяет этим организмам пережить неблагоприятные условия среды
Цитозин : Пиримидиновое основание, содержится во всех организмах в составе нуклеиновых кислот
Цитокинез : Процесс образования 2 новых клеток из одной – деление цитоплазмы
Цитология : Наука, изучающая строение, химический состав, функции клеток
Цитоплазма : Внеядерная часть протоплазмы клеток живых организмов; состоит из гиалоплазмы, в которой содержатся органоиды и клеточные включения
Черенкование : Отделение от растения части его стебля, корня или листа, приживление этого фрагмента с последующим восстановлением недостающих органов целостного растения
Шизогония : Бесполое размножение путем разделения тела на большое количество дочерних особей
Шизонт : Фаза подготовки клетки к шизогонии у некоторых простейших
Штамб : Ствол дерева между корнем и кроной
Штамм : Чистая одновидовая культура микроорганизмов, выделенная из определенного источника и обладающая специфическими признаками
Щиток : 1) соцветие; 2) первый семядольный лист зародыша злаков, прилегающий к эндосперму; 3) часть спинной части среднегруди насекомого
Эволюция : Необратимое и направленное историческое развитие живой природы, при котором происходит изменение генетического состава популяций
Экология : Раздел биологии, изучающий взаимоотношения организмов и их сообществ с окружающей средой
Экосистема : Единый природный или природно-антропогенный комплекс, образованный живыми организмами и средой их обитания
Экотоп : Место обитания сообществ
Экскременты : Твердые и жидкие испражнения животных
Экскрет : Конечный продукт обмена веществ
Экскреция : Удаление из организма конечных продуктов обмена веществ
Эктодерма : Наружный зародышевый листок эмбриона многоклеточных животных
Эктопаразит : Организм, паразитирующий на поверхности тела хозяина (вши, блохи)
Эктоплазма : Внешний слой цитоплазмы клеток
Эмаль : Плотные выделения, покрывающие зубную коронку
Эмбриогенез : Процесс зародышевого развития организма
Эмбрион : Организм животного, в ранний период развития - от начала дробления яйца до выхода из яйцевых оболочек
Эндемик : Местный вид, обитающий только в данном регионе
Эндодерма : Внутренний слой первичной коры в стеблях и корнях растений, регулирует поступление веществ в проводящие ткани
Эндопаразит : Организм, паразитирующий внутри хозяина (гельминты)
Эндоплазма : Внутренний слой цитоплазмы клеток, содержащий клеточные включения
Эндосперм : Запасающая триплоидная ткань семян растений, в которой откладываются питательные вещества, необходимые для развития зародыша
Эндотелий : Слой уплощенных клеток, образующихся из мезенхимы и выстилающих изнутри стенки кровеносных и лимфатических сосудов
Энтодерма : Внутренний слой эмбриона многоклеточных организмов, из которого формируются печень, легкие и поджелудочная железа
Эпидермис : Поверхностный слой кожи позвоночных животных, состоящий из многослойного эпителия
Эпителий : Ткань, покрывающая поверхность кожи, роговицу глаза и выстилающая все полости организма
Эпифит : Растение, поселяющееся на других растениях
Эритроцит : Красное кровяное тельце – безъядерные клетки, содержащие гемоглобин
Эрозия : Поверхностное повреждение эпителиального покрова кожи или слизистой оболочки
Этология : Наука, раздел зоологии о поведении животных в естественных условиях
Эукариота : Высший организм, четко оформленное ядро которого обладает оболочкой
Яйцеклетка : Неподвижно женская половая клетка, из которой развивается организм в результате оплодотворения
Ярус : Часть слоя в сообществе растений
